AAAACAGAGCACGCCGAGT -> AAACAGAGCACGCCGAGTA
AAAACAGCGTTAGGACGAA -> AAACAGCGTTAGGACGAAC
AAAACCCGCCCGTGACCAA -> AAACCCGCCCGTGACCAAG
AAAACGGGAGGTCTCCTAC -> AAACGGGAGGTCTCCTACG
AAAAGCCCTTTGATTCGCC -> AAAGCCCTTTGATTCGCCA
AAAAGTTACTGATAGTCAT -> AAAGTTACTGATAGTCATC
AAAAGTTTCTATTCTGAAG -> AAAGTTTCTATTCTGAAGC
AAAAGTTTCTTTATCTGGG -> AAAGTTTCTTTATCTGGGG
AAAATGTCGCCCAATATGA -> AAATGTCGCCCAATATGAT
AAAATTGGTGCCGCCCAAT -> AAATTGGTGCCGCCCAATT
AAAATTTGGCATACCCCTA -> AAATTTGGCATACCCCTAA
AAACAGAGCACGCCGAGTA -> AACAGAGCACGCCGAGTAA
AAACAGCGTTAGGACGAAC -> AACAGCGTTAGGACGAACT
AAACCAGCGCGTCCCGCCT -> AACCAGCGCGTCCCGCCTC
AAACCCGCCCGTGACCAAG -> AACCCGCCCGTGACCAAGC
AAACGGGAGGTCTCCTACG -> AACGGGAGGTCTCCTACGC
AAAGCAGCTCACAGGAGGC -> AAGCAGCTCACAGGAGGCG
AAAGCCCTTTGATTCGCCA -> AAGCCCTTTGATTCGCCAC
AAAGCTTTATACGGACCAG -> AAGCTTTATACGGACCAGT
AAAGTTACCCCACGTTTAT -> AAGTTACCCCACGTTTATG
AAAGTTACTGATAGTCATC -> AAGTTACTGATAGTCATCC
AAAGTTTCTATTCTGAAGC -> AAGTTTCTATTCTGAAGCT
AAAGTTTCTTTATCTGGGG -> AAGTTTCTTTATCTGGGGC
AAATCAAAACAGCGTTAGG -> AATCAAAACAGCGTTAGGA
AAATCGAGGGGCTGGCGAT -> AATCGAGGGGCTGGCGATT
AAATCTGGAATGGTACGAG -> AATCTGGAATGGTACGAGT
AAATGACCCCTTAGACCGC -> AATGACCCCTTAGACCGCG
AAATGTCGCCCAATATGAT -> AATGTCGCCCAATATGATC
AAATTCATACGAAGCACAG -> AATTCATACGAAGCACAGG
AAATTCCCTTCCGGAGCAG -> AATTCCCTTCCGGAGCAGT
AAATTGGTGCCGCCCAATT -> AATTGGTGCCGCCCAATTG
AAATTTGGCATACCCCTAA -> AATTTGGCATACCCCTAAC
AACAACTTCCACACGAAGT -> ACAACTTCCACACGAAGTA
AACACTCGGACTTCTCCCC -> ACACTCGGACTTCTCCCCC
AACAGAGCACGCCGAGTAA -> ACAGAGCACGCCGAGTAAG
AACAGCGTTAGGACGAACT -> ACAGCGTTAGGACGAACTA
AACAGGACATGCCCGTACT -> ACAGGACATGCCCGTACTA
AACATAGATACCAGGCTAT -> ACATAGATACCAGGCTATC
AACATCTACTCCAGTGGCC -> ACATCTACTCCAGTGGCCG
AACATGCTGCCAGACTAAC -> ACATGCTGCCAGACTAACA
AACATTAGCGAGAAATCAA -> ACATTAGCGAGAAATCAAA
AACCAGCGCGTCCCGCCTC -> ACCAGCGCGTCCCGCCTCA
AACCAGTCGTCACAGCTCA -> ACCAGTCGTCACAGCTCAA
AACCCAGGCCCGGAAATTC -> ACCCAGGCCCGGAAATTCC
AACCCCTCGGTCCAGCGCT -> ACCCCTCGGTCCAGCGCTA
AACCCCTGTGGCAGAAAGC -> ACCCCTGTGGCAGAAAGCA
AACCCGCCCGTGACCAAGC -> ACCCGCCCGTGACCAAGCT
AACCTGACAGAGTACCAAC -> ACCTGACAGAGTACCAACC
AACCTGACAGAGTACCCAG -> ACCTGACAGAGTACCCAGA
AACCTGACAGAGTAGGTCT -> ACCTGACAGAGTAGGTCTG
AACCTGACAGAGTATCTCA -> ACCTGACAGAGTATCTCAG
AACGAACTGAGTTTTCTAC -> ACGAACTGAGTTTTCTACG
AACGCAGTAGTCAAGGCGA -> ACGCAGTAGTCAAGGCGAA
AACGCATCCGGATCGCTTT -> ACGCATCCGGATCGCTTTA
AACGCCAATAATTTTGATA -> ACGCCAATAATTTTGATAT
AACGCCCACGCCCCCCCTA -> ACGCCCACGCCCCCCCTAA
AACGGGAGGTCTCCTACGC -> ACGGGAGGTCTCCTACGCC
AACGGTTGCCTTAGCAGGT -> ACGGTTGCCTTAGCAGGTT
AACGTGCCGACTCTACCAG -> ACGTGCCGACTCTACCAGG
AACTAGGGGCCTAGGCAAG -> ACTAGGGGCCTAGGCAAGA
AACTAGGTCGCTACGCGTC -> ACTAGGTCGCTACGCGTCA
AACTCTCTGACACTCGTGG -> ACTCTCTGACACTCGTGGA
AACTGAGTTTTCTACGCTA -> ACTGAGTTTTCTACGCTAA
AACTTAAGTCCAAAAGCCC -> ACTTAAGTCCAAAAGCCCT
AACTTCCACACGAAGTATA -> ACTTCCACACGAAGTATAG
AACTTGGGGTAGTACATGT -> ACTTGGGGTAGTACATGTT
AAGAAATCGAGGGGCTGGC -> AGAAATCGAGGGGCTGGCG
AAGACAAGCAGGCGCTTGC -> AGACAAGCAGGCGCTTGCT
AAGACAGCCATTTGCTTTC -> AGACAGCCATTTGCTTTCG
AAGACCAGACGTAGGGGAC -> AGACCAGACGTAGGGGACA
AAGACGCAGACTTAACGAA -> AGACGCAGACTTAACGAAC
AAGAGGAGGGACTGAAGGC -> AGAGGAGGGACTGAAGGCT
AAGAGGGTCGTACCTATGT -> AGAGGGTCGTACCTATGTT
AAGATCACGGATAGCCCGA -> AGATCACGGATAGCCCGAT
AAGCACAGGAGGATTCGCC -> AGCACAGGAGGATTCGCCC
AAGCAGCTCACAGGAGGCG -> AGCAGCTCACAGGAGGCGT
AAGCAGGCGCTTGCTGGGG -> AGCAGGCGCTTGCTGGGGC
AAGCAGTAGAAGTCTTCCT -> AGCAGTAGAAGTCTTCCTC
AAGCCCTTTGATTCGCCAC -> AGCCCTTTGATTCGCCACG
AAGCCTTCTTTCATCCGTC -> AGCCTTCTTTCATCCGTCC
AAGCGTTGATCGACCTGTG -> AGCGTTGATCGACCTGTGT
AAGCTAACAGGACATGCCC -> AGCTAACAGGACATGCCCG
AAGCTGACGGAACGTGCCG -> AGCTGACGGAACGTGCCGA
AAGCTTTATACGGACCAGT -> AGCTTTATACGGACCAGTG
AAGGACTAGGTGAGTGTGA -> AGGACTAGGTGAGTGTGAA
AAGGCACTGGTCCCCTACG -> AGGCACTGGTCCCCTACGT
AAGGCCGGGCACTGTGAAA -> AGGCCGGGCACTGTGAAAA
AAGGCGAACCAGTCGTCAC -> AGGCGAACCAGTCGTCACA
AAGGCTGGAGCGATATTAA -> AGGCTGGAGCGATATTAAT
AAGGGCACCCATTCCCCTA -> AGGGCACCCATTCCCCTAA
AAGGGTATATTTGAGTGAG -> AGGGTATATTTGAGTGAGG
AAGGTCAAAAGTTTCTATT -> AGGTCAAAAGTTTCTATTC
AAGGTGAGATTGAAGAGGA -> AGGTGAGATTGAAGAGGAG
AAGTAAAATTGGTGCCGCC -> AGTAAAATTGGTGCCGCCC
AAGTATAGCCCGATTTCAA -> AGTATAGCCCGATTTCAAA
AAGTCCAAAAGCCCTTTGA -> AGTCCAAAAGCCCTTTGAT
AAGTCTTCCTCGATCGGGG -> AGTCTTCCTCGATCGGGGA
AAGTGGCAGGCGGCCAAGA -> AGTGGCAGGCGGCCAAGAC
AAGTTACAATCCGGGCGTA -> AGTTACAATCCGGGCGTAC
AAGTTACCAGGCTATCGTC -> AGTTACCAGGCTATCGTCC
AAGTTACCCCACGTTTATG -> AGTTACCCCACGTTTATGC
AAGTTACTGATAGTCATCC -> AGTTACTGATAGTCATCCC
AAGTTGTTGTTAAGGGTAT -> AGTTGTTGTTAAGGGTATA
AAGTTGTTTTTCGATCAAA -> AGTTGTTTTTCGATCAAAA
AAGTTTAACGCCAATAATT -> AGTTTAACGCCAATAATTT
AAGTTTCTATTCTGAAGCT -> AGTTTCTATTCTGAAGCTA
AAGTTTCTTTATCTGGGGC -> AGTTTCTTTATCTGGGGCG
AATAATTTTGATATCGAAG -> ATAATTTTGATATCGAAGA
AATACCATAGCACCTGCTG -> ATACCATAGCACCTGCTGA
AATACCGAAGTTGTTGTTA -> ATACCGAAGTTGTTGTTAA
AATATGATCCTAGACAGTA -> ATATGATCCTAGACAGTAT
AATATTAGTCACATTCATA -> ATATTAGTCACATTCATAC
AATCAAAACAGCGTTAGGA -> ATCAAAACAGCGTTAGGAC
AATCAGTCGTTCAGCCCTT -> ATCAGTCGTTCAGCCCTTA
AATCCGGGCGTACATCATA -> ATCCGGGCGTACATCATAC
AATCGAGGGGCTGGCGATT -> ATCGAGGGGCTGGCGATTG
AATCGGTGGTCCACGAGAA -> ATCGGTGGTCCACGAGAAC
AATCTAAGTTGTTTTTCGA -> ATCTAAGTTGTTTTTCGAT
AATCTGGAATGGTACGAGT -> ATCTGGAATGGTACGAGTG
AATGACCCCTTAGACCGCG -> ATGACCCCTTAGACCGCGT
AATGCTAGTCGGCACTCGA -> ATGCTAGTCGGCACTCGAG
AATGGGTCCGGCGGCGAGG -> ATGGGTCCGGCGGCGAGGA
AATGGTACGAGTGAAGTAA -> ATGGTACGAGTGAAGTAAA
AATGTCGCCCAATATGATC -> ATGTCGCCCAATATGATCC
AATGTTCCAACACTCGGAC -> ATGTTCCAACACTCGGACT
AATTCATACGAAGCACAGG -> ATTCATACGAAGCACAGGA
AATTCCCTTCCGGAGCAGT -> ATTCCCTTCCGGAGCAGTT
AATTCCTATCGTTCCCCTA -> ATTCCTATCGTTCCCCTAA
AATTCTGTTAGCCTGGGCT -> ATTCTGTTAGCCTGGGCTT
AATTGAAAAGTTTCTTTAT -> ATTGAAAAGTTTCTTTATC
AATTGAGAGTATCCAATCA -> ATTGAGAGTATCCAATCAG
AATTGGTGCCGCCCAATTG -> ATTGGTGCCGCCCAATTGA
AATTTCGCGTTGTCTATGT -> ATTTCGCGTTGTCTATGTT
AATTTGGCATACCCCTAAC -> ATTTGGCATACCCCTAACC
AATTTTGATATCGAAGACA -> ATTTTGATATCGAAGACAA
ACAACGGTTGCCTTAGCAG -> CAACGGTTGCCTTAGCAGG
ACAACTTCCACACGAAGTA -> CAACTTCCACACGAAGTAT
ACAAGCAGGCGCTTGCTGG -> CAAGCAGGCGCTTGCTGGG
ACAATATTAGTCACATTCA -> CAATATTAGTCACATTCAT
ACAATCCGGGCGTACATCA -> CAATCCGGGCGTACATCAT
ACAATTCTGTTAGCCTGGG -> CAATTCTGTTAGCCTGGGC
ACACACTGTTCGGCATCCC -> CACACTGTTCGGCATCCCC
ACACCCTGGTAAGGTCAAA -> CACCCTGGTAAGGTCAAAA
ACACGAAGTATAGCCCGAT -> CACGAAGTATAGCCCGATT
ACACTACCAAGAAATCGAG -> CACTACCAAGAAATCGAGG
ACACTCGGACTTCTCCCCC -> CACTCGGACTTCTCCCCCA
ACACTCGTGGAGCATAAGG -> CACTCGTGGAGCATAAGGC
ACACTGAAGACAGCCATTT -> CACTGAAGACAGCCATTTG
ACACTGTTCGGCATCCCCT -> CACTGTTCGGCATCCCCTT
ACAGAGCACGCCGAGTAAG -> CAGAGCACGCCGAGTAAGG
ACAGAGTACCAACCCAGGC -> CAGAGTACCAACCCAGGCC
ACAGAGTACCCAGAGAGCT -> CAGAGTACCCAGAGAGCTA
ACAGAGTAGGTCTGGTGAT -> CAGAGTAGGTCTGGTGATA
ACAGAGTATCTCAGCTGTC -> CAGAGTATCTCAGCTGTCT
ACAGCCATTTGCTTTCGTA -> CAGCCATTTGCTTTCGTAA
ACAGCGTTAGGACGAACTA -> CAGCGTTAGGACGAACTAG
ACAGCTACTTTGGAGCAAT -> CAGCTACTTTGGAGCAATG
ACAGCTCAAAGTTACCCCA -> CAGCTCAAAGTTACCCCAC
ACAGCTGCACTAAAACGGG -> CAGCTGCACTAAAACGGGA
ACAGGACATGCCCGTACTA -> CAGGACATGCCCGTACTAG
ACAGGAGGATTCGCCCAAG -> CAGGAGGATTCGCCCAAGC
ACAGGAGGCGTCCTCTTCC -> CAGGAGGCGTCCTCTTCCC
ACAGTAACCCCTCGGTCCA -> CAGTAACCCCTCGGTCCAG
ACAGTAGCAGATGAACATG -> CAGTAGCAGATGAACATGC
ACAGTATGATGTTAACATT -> CAGTATGATGTTAACATTA
ACATAGATACCAGGCTATC -> CATAGATACCAGGCTATCG
ACATCAGGCCACGAGCTGT -> CATCAGGCCACGAGCTGTT
ACATCATACAATATTAGTC -> CATCATACAATATTAGTCA
ACATCTACTCCAGTGGCCG -> CATCTACTCCAGTGGCCGC
ACATGCCCGTACTAGACAC -> CATGCCCGTACTAGACACT
ACATGCTGCCAGACTAACA -> CATGCTGCCAGACTAACAT
ACATGGGTCTGTGTTCTGT -> CATGGGTCTGTGTTCTGTT
ACATGTTTTTAGGACATTC -> CATGTTTTTAGGACATTCT
ACATTAGCGAGAAATCAAA -> CATTAGCGAGAAATCAAAA
ACATTCATACTTCTGAAAA -> CATTCATACTTCTGAAAAC
ACATTCTCCTGGACCCCCA -> CATTCTCCTGGACCCCCAC
ACCAACCCAGGCCCGGAAA -> CCAACCCAGGCCCGGAAAT
ACCAAGAAATCGAGGGGCT -> CCAAGAAATCGAGGGGCTG
ACCAAGCAGTAGAAGTCTT -> CCAAGCAGTAGAAGTCTTC
ACCAAGCTGACGGAACGTG -> CCAAGCTGACGGAACGTGC
ACCAGACGTAGGGGACAGT -> CCAGACGTAGGGGACAGTA
ACCAGCGCGTCCCGCCTCA -> CCAGCGCGTCCCGCCTCAG
ACCAGGCTATCGTCCAAAA -> CCAGGCTATCGTCCAAAAT
ACCAGGCTATCGTCCAACG -> CCAGGCTATCGTCCAACGC
ACCAGGCTATCGTCCAAGG -> CCAGGCTATCGTCCAAGGG
ACCAGGCTATCGTCCAATT -> CCAGGCTATCGTCCAATTC
ACCAGTCGTCACAGCTCAA -> CCAGTCGTCACAGCTCAAA
ACCAGTGGCGCATAATACC -> CCAGTGGCGCATAATACCA
ACCATAGCACCTGCTGAAC -> CCATAGCACCTGCTGAACG
ACCATCGAAGCCTTCTTTC -> CCATCGAAGCCTTCTTTCA
ACCCAACTTGGGGTAGTAC -> CCCAACTTGGGGTAGTACA
ACCCAGAGAGCTAAGTTTA -> CCCAGAGAGCTAAGTTTAA
ACCCAGGCCCGGAAATTCC -> CCCAGGCCCGGAAATTCCC
ACCCATTCCCCTAACCTGA -> CCCATTCCCCTAACCTGAC
ACCCCACGTTTATGCCTCC -> CCCCACGTTTATGCCTCCC
ACCCCCACACTGAAGACAG -> CCCCCACACTGAAGACAGC
ACCCCTAACCTGACAGAGT -> CCCCTAACCTGACAGAGTA
ACCCCTCGGTCCAGCGCTA -> CCCCTCGGTCCAGCGCTAG
ACCCCTGTGGCAGAAAGCA -> CCCCTGTGGCAGAAAGCAG
ACCCCTTAGACCGCGTCAA -> CCCCTTAGACCGCGTCAAT
ACCCGCCCGTGACCAAGCT -> CCCGCCCGTGACCAAGCTG
ACCCTGGTAAGGTCAAAAG -> CCCTGGTAAGGTCAAAAGT
ACCGAAGTTGTTGTTAAGG -> CCGAAGTTGTTGTTAAGGG
ACCGCGGAACTAGGTCGCT -> CCGCGGAACTAGGTCGCTA
ACCGCGTCAATTGAAAAGT -> CCGCGTCAATTGAAAAGTT
ACCTATGTTCCTCGACAAT -> CCTATGTTCCTCGACAATT
ACCTGACAGAGTACCAACC -> CCTGACAGAGTACCAACCC
ACCTGACAGAGTACCCAGA -> CCTGACAGAGTACCCAGAG
ACCTGACAGAGTAGGTCTG -> CCTGACAGAGTAGGTCTGG
ACCTGACAGAGTATCTCAG -> CCTGACAGAGTATCTCAGC
ACCTGCTGAACGCATCCGG -> CCTGCTGAACGCATCCGGA
ACCTGTGTTCGGCTCCCCT -> CCTGTGTTCGGCTCCCCTA
ACGAACTAGGGGCCTAGGC -> CGAACTAGGGGCCTAGGCA
ACGAACTGAGTTTTCTACG -> CGAACTGAGTTTTCTACGC
ACGAAGCACAGGAGGATTC -> CGAAGCACAGGAGGATTCG
ACGAAGTATAGCCCGATTT -> CGAAGTATAGCCCGATTTC
ACGAGAACATCTACTCCAG -> CGAGAACATCTACTCCAGT
ACGAGCTGTTGGCCTTCTC -> CGAGCTGTTGGCCTTCTCC
ACGAGTGAAGTAAAATTGG -> CGAGTGAAGTAAAATTGGT
ACGCAGACTTAACGAACTG -> CGCAGACTTAACGAACTGA
ACGCAGTAGTCAAGGCGAA -> CGCAGTAGTCAAGGCGAAC
ACGCATCCGGATCGCTTTA -> CGCATCCGGATCGCTTTAG
ACGCCAATAATTTTGATAT -> CGCCAATAATTTTGATATC
ACGCCCACGCCCCCCCTAA -> CGCCCACGCCCCCCCTAAC
ACGCCCCCCCTAACCTGAC -> CGCCCCCCCTAACCTGACA
ACGCCCTGGGAACAACTTC -> CGCCCTGGGAACAACTTCC
ACGCCGAGTAAGGCCGGGC -> CGCCGAGTAAGGCCGGGCA
ACGCGTCAATGCTAGTCGG -> CGCGTCAATGCTAGTCGGC
ACGCTAAGAGGGTCGTACC -> CGCTAAGAGGGTCGTACCT
ACGCTGGGGTACCAGGCTA -> CGCTGGGGTACCAGGCTAT
ACGGAACGTGCCGACTCTA -> CGGAACGTGCCGACTCTAC
ACGGAAGTTACCAGGCTAT -> CGGAAGTTACCAGGCTATC
ACGGACCAGTGGCGCATAA -> CGGACCAGTGGCGCATAAT
ACGGATAGCCCGATGCTCG -> CGGATAGCCCGATGCTCGC
ACGGGAGGTCTCCTACGCC -> CGGGAGGTCTCCTACGCCC
ACGGTTGCCTTAGCAGGTT -> CGGTTGCCTTAGCAGGTTA
ACGTAGGGGACAGTAGCAG -> CGTAGGGGACAGTAGCAGA
ACGTATAAAATGTCGCCCA -> CGTATAAAATGTCGCCCAA
ACGTCCTGTATATTTTAGC -> CGTCCTGTATATTTTAGCC
ACGTGCCGACTCTACCAGG -> CGTGCCGACTCTACCAGGC
ACGTGTTTCGGTGTGCGCG -> CGTGTTTCGGTGTGCGCGA
ACGTTTATGCCTCCCTAAT -> CGTTTATGCCTCCCTAATT
ACTAAAACGGGAGGTCTCC -> CTAAAACGGGAGGTCTCCT
ACTAACATAGATACCAGGC -> CTAACATAGATACCAGGCT
ACTACCAAGAAATCGAGGG -> CTACCAAGAAATCGAGGGG
ACTACGTATAAAATGTCGC -> CTACGTATAAAATGTCGCC
ACTAGACACTACCAAGAAA -> CTAGACACTACCAAGAAAT
ACTAGGGGCCTAGGCAAGA -> CTAGGGGCCTAGGCAAGAC
ACTAGGTCGCTACGCGTCA -> CTAGGTCGCTACGCGTCAA
ACTAGGTGAGTGTGAATAC -> CTAGGTGAGTGTGAATACC
ACTCCAGTGGCCGCATAGT -> CTCCAGTGGCCGCATAGTA
ACTCGAGGGCTGCCGAGGC -> CTCGAGGGCTGCCGAGGCC
ACTCGGACTTCTCCCCCAC -> CTCGGACTTCTCCCCCACC
ACTCGTGGAGCATAAGGCA -> CTCGTGGAGCATAAGGCAC
ACTCTACCAGGCTATCGTC -> CTCTACCAGGCTATCGTCC
ACTCTCTGACACTCGTGGA -> CTCTCTGACACTCGTGGAG
ACTGAAGACAGCCATTTGC -> CTGAAGACAGCCATTTGCT
ACTGAAGGCTGGAGCGATA -> CTGAAGGCTGGAGCGATAT
ACTGAGTTTTCTACGCTAA -> CTGAGTTTTCTACGCTAAG
ACTGATAGTCATCCCCGAT -> CTGATAGTCATCCCCGATC
ACTGGTCCCCTACGTGTTT -> CTGGTCCCCTACGTGTTTC
ACTGTGAAAACCCGCCCGT -> CTGTGAAAACCCGCCCGTG
ACTGTTCGGCATCCCCTTT -> CTGTTCGGCATCCCCTTTG
ACTTAACGAACTGAGTTTT -> CTTAACGAACTGAGTTTTC
ACTTAAGTCCAAAAGCCCT -> CTTAAGTCCAAAAGCCCTT
ACTTCCACACGAAGTATAG -> CTTCCACACGAAGTATAGC
ACTTCTCCCCCACCCAACT -> CTTCTCCCCCACCCAACTT
ACTTCTGAAAACAGAGCAC -> CTTCTGAAAACAGAGCACG
ACTTGCGTCCAAGTGGCAG -> CTTGCGTCCAAGTGGCAGG
ACTTGGGGTAGTACATGTT -> CTTGGGGTAGTACATGTTT
ACTTTGGAGCAATGTTCCA -> CTTTGGAGCAATGTTCCAA
AGAAAGCAGCTCACAGGAG -> GAAAGCAGCTCACAGGAGG
AGAAATCAAAACAGCGTTA -> GAAATCAAAACAGCGTTAG
AGAAATCGAGGGGCTGGCG -> GAAATCGAGGGGCTGGCGA
AGAACATCTACTCCAGTGG -> GAACATCTACTCCAGTGGC
AGAACCCCTGTGGCAGAAA -> GAACCCCTGTGGCAGAAAG
AGAAGTCTTCCTCGATCGG -> GAAGTCTTCCTCGATCGGG
AGACAAGCAGGCGCTTGCT -> GACAAGCAGGCGCTTGCTG
AGACACTACCAAGAAATCG -> GACACTACCAAGAAATCGA
AGACAGCCATTTGCTTTCG -> GACAGCCATTTGCTTTCGT
AGACAGTATGATGTTAACA -> GACAGTATGATGTTAACAT
AGACATCAGGCCACGAGCT -> GACATCAGGCCACGAGCTG
AGACCAGACGTAGGGGACA -> GACCAGACGTAGGGGACAG
AGACCGCGTCAATTGAAAA -> GACCGCGTCAATTGAAAAG
AGACGCAGACTTAACGAAC -> GACGCAGACTTAACGAACT
AGACGTAGGGGACAGTAGC -> GACGTAGGGGACAGTAGCA
AGACTAACATAGATACCAG -> GACTAACATAGATACCAGG
AGACTTAACGAACTGAGTT -> GACTTAACGAACTGAGTTT
AGAGAGCTAAGTTTAACGC -> GAGAGCTAAGTTTAACGCC
AGAGCACGCCGAGTAAGGC -> GAGCACGCCGAGTAAGGCC
AGAGCTAAGTTTAACGCCA -> GAGCTAAGTTTAACGCCAA
AGAGGAGGGACTGAAGGCT -> GAGGAGGGACTGAAGGCTG
AGAGGGTCGTACCTATGTT -> GAGGGTCGTACCTATGTTC
AGAGTACCAACCCAGGCCC -> GAGTACCAACCCAGGCCCG
AGAGTACCCAGAGAGCTAA -> GAGTACCCAGAGAGCTAAG
AGAGTAGGTCTGGTGATAT -> GAGTAGGTCTGGTGATATA
AGAGTATCCAATCAGTCGT -> GAGTATCCAATCAGTCGTT
AGAGTATCTCAGCTGTCTA -> GAGTATCTCAGCTGTCTAG
AGATACCAGGCTATCGTCC -> GATACCAGGCTATCGTCCA
AGATCACGGATAGCCCGAT -> GATCACGGATAGCCCGATG
AGATGAACATGCTGCCAGA -> GATGAACATGCTGCCAGAC
AGATTAGGTTTTTTGAAAT -> GATTAGGTTTTTTGAAATC
AGATTGAAGAGGAGGGACT -> GATTGAAGAGGAGGGACTG
AGCAATGTTCCAACACTCG -> GCAATGTTCCAACACTCGG
AGCACAGGAGGATTCGCCC -> GCACAGGAGGATTCGCCCA
AGCACCTGCTGAACGCATC -> GCACCTGCTGAACGCATCC
AGCACGCCGAGTAAGGCCG -> GCACGCCGAGTAAGGCCGG
AGCAGATGAACATGCTGCC -> GCAGATGAACATGCTGCCA
AGCAGCTCACAGGAGGCGT -> GCAGCTCACAGGAGGCGTC
AGCAGGCGCTTGCTGGGGC -> GCAGGCGCTTGCTGGGGCG
AGCAGGTTATTAATCGGTG -> GCAGGTTATTAATCGGTGG
AGCAGTAGAAGTCTTCCTC -> GCAGTAGAAGTCTTCCTCG
AGCAGTTTAGACATCAGGC -> GCAGTTTAGACATCAGGCC
AGCATAAGGCACTGGTCCC -> GCATAAGGCACTGGTCCCC
AGCATGGGTTAGATTAGGT -> GCATGGGTTAGATTAGGTT
AGCCATGGGTTTCACAACG -> GCCATGGGTTTCACAACGG
AGCCATTTGCTTTCGTAAC -> GCCATTTGCTTTCGTAACT
AGCCCGATGCTCGCGAGCA -> GCCCGATGCTCGCGAGCAT
AGCCCGATTTCAAACCAGC -> GCCCGATTTCAAACCAGCG
AGCCCTTATCCAAATTCAT -> GCCCTTATCCAAATTCATA
AGCCCTTTGATTCGCCACG -> GCCCTTTGATTCGCCACGT
AGCCTGGGCTTACTACGTA -> GCCTGGGCTTACTACGTAT
AGCCTTCTTTCATCCGTCC -> GCCTTCTTTCATCCGTCCA
AGCGAGAAATCAAAACAGC -> GCGAGAAATCAAAACAGCG
AGCGATATTAATCTAAGTT -> GCGATATTAATCTAAGTTG
AGCGCGTCCCGCCTCAGGT -> GCGCGTCCCGCCTCAGGTC
AGCGCTAGAACCCCTGTGG -> GCGCTAGAACCCCTGTGGC
AGCGGCGTCACGGAAGTTA -> GCGGCGTCACGGAAGTTAC
AGCGGTACACCCTGGTAAG -> GCGGTACACCCTGGTAAGG
AGCGTTAGGACGAACTAGG -> GCGTTAGGACGAACTAGGG
AGCGTTGATCGACCTGTGT -> GCGTTGATCGACCTGTGTT
AGCTAACAGGACATGCCCG -> GCTAACAGGACATGCCCGT
AGCTAAGTTTAACGCCAAT -> GCTAAGTTTAACGCCAATA
AGCTACTTTGGAGCAATGT -> GCTACTTTGGAGCAATGTT
AGCTCAAAGTTACCCCACG -> GCTCAAAGTTACCCCACGT
AGCTCACAGGAGGCGTCCT -> GCTCACAGGAGGCGTCCTC
AGCTGACGGAACGTGCCGA -> GCTGACGGAACGTGCCGAC
AGCTGCACTAAAACGGGAG -> GCTGCACTAAAACGGGAGG
AGCTGTCTAGTTGGTCATC -> GCTGTCTAGTTGGTCATCG
AGCTGTTGGCCTTCTCCAT -> GCTGTTGGCCTTCTCCATG
AGCTTTATACGGACCAGTG -> GCTTTATACGGACCAGTGG
AGGAAAGCTTTATACGGAC -> GGAAAGCTTTATACGGACC
AGGAAGATCACGGATAGCC -> GGAAGATCACGGATAGCCC
AGGACATGCCCGTACTAGA -> GGACATGCCCGTACTAGAC
AGGACATTCTCCTGGACCC -> GGACATTCTCCTGGACCCC
AGGACGAACTAGGGGCCTA -> GGACGAACTAGGGGCCTAG
AGGACTAGGTGAGTGTGAA -> GGACTAGGTGAGTGTGAAT
AGGAGGATTCGCCCAAGCG -> GGAGGATTCGCCCAAGCGT
AGGAGGCGTCCTCTTCCCG -> GGAGGCGTCCTCTTCCCGT
AGGAGGGACTGAAGGCTGG -> GGAGGGACTGAAGGCTGGA
AGGATTCGCCCAAGCGTTG -> GGATTCGCCCAAGCGTTGA
AGGCAAGACCAGACGTAGG -> GGCAAGACCAGACGTAGGG
AGGCACTGGTCCCCTACGT -> GGCACTGGTCCCCTACGTG
AGGCCACGAGCTGTTGGCC -> GGCCACGAGCTGTTGGCCT
AGGCCCGGAAATTCCCTTC -> GGCCCGGAAATTCCCTTCC
AGGCCGGGCACTGTGAAAA -> GGCCGGGCACTGTGAAAAC
AGGCCTCTCGCAACCTCAA -> GGCCTCTCGCAACCTCAAG
AGGCGAACCAGTCGTCACA -> GGCGAACCAGTCGTCACAG
AGGCGCTTGCTGGGGCGCT -> GGCGCTTGCTGGGGCGCTC
AGGCGGCCAAGACGCAGAC -> GGCGGCCAAGACGCAGACT
AGGCGTCCTCTTCCCGTGG -> GGCGTCCTCTTCCCGTGGT
AGGCTATCGTCCAAAATTT -> GGCTATCGTCCAAAATTTG
AGGCTATCGTCCAACGCCC -> GGCTATCGTCCAACGCCCA
AGGCTATCGTCCAAGGGCA -> GGCTATCGTCCAAGGGCAC
AGGCTATCGTCCAATTCCT -> GGCTATCGTCCAATTCCTA
AGGCTGGAGCGATATTAAT -> GGCTGGAGCGATATTAATC
AGGGACTGAAGGCTGGAGC -> GGGACTGAAGGCTGGAGCG
AGGGCACCCATTCCCCTAA -> GGGCACCCATTCCCCTAAC
AGGGCTGCCGAGGCCTCTC -> GGGCTGCCGAGGCCTCTCG
AGGGGACAGTAGCAGATGA -> GGGGACAGTAGCAGATGAA
AGGGGCCTAGGCAAGACCA -> GGGGCCTAGGCAAGACCAG
AGGGGCTGGCGATTGGATG -> GGGGCTGGCGATTGGATGC
AGGGTATATTTGAGTGAGG -> GGGTATATTTGAGTGAGGA
AGGGTCGTACCTATGTTCC -> GGGTCGTACCTATGTTCCT
AGGTAGCGGCGTCACGGAA -> GGTAGCGGCGTCACGGAAG
AGGTCAAAAGTTTCTATTC -> GGTCAAAAGTTTCTATTCT
AGGTCGCTACGCGTCAATG -> GGTCGCTACGCGTCAATGC
AGGTCTCCTACGCCCTGGG -> GGTCTCCTACGCCCTGGGA
AGGTCTGGTGATATACAGT -> GGTCTGGTGATATACAGTA
AGGTCTTCAGTACAGCTAC -> GGTCTTCAGTACAGCTACT
AGGTGAGATTGAAGAGGAG -> GGTGAGATTGAAGAGGAGG
AGGTGAGTGTGAATACCGA -> GGTGAGTGTGAATACCGAA
AGGTTATTAATCGGTGGTC -> GGTTATTAATCGGTGGTCC
AGGTTTTTTGAAATCTGGA -> GGTTTTTTGAAATCTGGAA
AGTAAAATTGGTGCCGCCC -> GTAAAATTGGTGCCGCCCA
AGTAACCCCTCGGTCCAGC -> GTAACCCCTCGGTCCAGCG
AGTAAGGCCGGGCACTGTG -> GTAAGGCCGGGCACTGTGA
AGTACAGCTACTTTGGAGC -> GTACAGCTACTTTGGAGCA
AGTACATGTTTTTAGGACA -> GTACATGTTTTTAGGACAT
AGTACCAACCCAGGCCCGG -> GTACCAACCCAGGCCCGGA
AGTACCCAGAGAGCTAAGT -> GTACCCAGAGAGCTAAGTT
AGTACTTGCGTCCAAGTGG -> GTACTTGCGTCCAAGTGGC
AGTAGAAGTCTTCCTCGAT -> GTAGAAGTCTTCCTCGATC
AGTAGCAGATGAACATGCT -> GTAGCAGATGAACATGCTG
AGTAGGTCTGGTGATATAC -> GTAGGTCTGGTGATATACA
AGTAGTCAAGGCGAACCAG -> GTAGTCAAGGCGAACCAGT
AGTAGTCGGATCCCATTAT -> GTAGTCGGATCCCATTATG
AGTATAGCCCGATTTCAAA -> GTATAGCCCGATTTCAAAC
AGTATCCAATCAGTCGTTC -> GTATCCAATCAGTCGTTCA
AGTATCTCAGCTGTCTAGT -> GTATCTCAGCTGTCTAGTT
AGTATGATGTTAACATTAG -> GTATGATGTTAACATTAGC
AGTCAAGGCGAACCAGTCG -> GTCAAGGCGAACCAGTCGT
AGTCACATTCATACTTCTG -> GTCACATTCATACTTCTGA
AGTCATCCCCGATCTGTCC -> GTCATCCCCGATCTGTCCT
AGTCCAAAAGCCCTTTGAT -> GTCCAAAAGCCCTTTGATT
AGTCGGATCCCATTATGTC -> GTCGGATCCCATTATGTCA
AGTCGGCACTCGAGGGCTG -> GTCGGCACTCGAGGGCTGC
AGTCGTCACAGCTCAAAGT -> GTCGTCACAGCTCAAAGTT
AGTCGTTCAGCCCTTATCC -> GTCGTTCAGCCCTTATCCA
AGTCTTCCTCGATCGGGGA -> GTCTTCCTCGATCGGGGAC
AGTGAAGTAAAATTGGTGC -> GTGAAGTAAAATTGGTGCC
AGTGAGGAAAGCTTTATAC -> GTGAGGAAAGCTTTATACG
AGTGGCAGGCGGCCAAGAC -> GTGGCAGGCGGCCAAGACG
AGTGGCCGCATAGTAGTCG -> GTGGCCGCATAGTAGTCGG
AGTGGCGCATAATACCATA -> GTGGCGCATAATACCATAG
AGTGTGAATACCGAAGTTG -> GTGTGAATACCGAAGTTGT
AGTTACAATCCGGGCGTAC -> GTTACAATCCGGGCGTACA
AGTTACCAGGCTATCGTCC -> GTTACCAGGCTATCGTCCA
AGTTACCCCACGTTTATGC -> GTTACCCCACGTTTATGCC
AGTTACTGATAGTCATCCC -> GTTACTGATAGTCATCCCC
AGTTCCGGGTGGATAAGGT -> GTTCCGGGTGGATAAGGTG
AGTTGGTCATCGGATAGGT -> GTTGGTCATCGGATAGGTA
AGTTGTTGTTAAGGGTATA -> GTTGTTGTTAAGGGTATAT
AGTTGTTTTTCGATCAAAA -> GTTGTTTTTCGATCAAAAG
AGTTTAACGCCAATAATTT -> GTTTAACGCCAATAATTTT
AGTTTAGACATCAGGCCAC -> GTTTAGACATCAGGCCACG
AGTTTCTATTCTGAAGCTA -> GTTTCTATTCTGAAGCTAA
AGTTTCTTTATCTGGGGCG -> GTTTCTTTATCTGGGGCGC
AGTTTTCTACGCTAAGAGG -> GTTTTCTACGCTAAGAGGG
ATAAAATGTCGCCCAATAT -> TAAAATGTCGCCCAATATG
ATAAGGCACTGGTCCCCTA -> TAAGGCACTGGTCCCCTAC
ATAAGGTGAGATTGAAGAG -> TAAGGTGAGATTGAAGAGG
ATAATACCATAGCACCTGC -> TAATACCATAGCACCTGCT
ATAATGGGTCCGGCGGCGA -> TAATGGGTCCGGCGGCGAG
ATAATTTTGATATCGAAGA -> TAATTTTGATATCGAAGAC
ATACAATATTAGTCACATT -> TACAATATTAGTCACATTC
ATACAGTAACCCCTCGGTC -> TACAGTAACCCCTCGGTCC
ATACCAGGCTATCGTCCAA -> TACCAGGCTATCGTCCAAA
ATACCATAGCACCTGCTGA -> TACCATAGCACCTGCTGAA
ATACCCCTAACCTGACAGA -> TACCCCTAACCTGACAGAG
ATACCGAAGTTGTTGTTAA -> TACCGAAGTTGTTGTTAAG
ATACGAAGCACAGGAGGAT -> TACGAAGCACAGGAGGATT
ATACGGACCAGTGGCGCAT -> TACGGACCAGTGGCGCATA
ATACTTCTGAAAACAGAGC -> TACTTCTGAAAACAGAGCA
ATAGATACCAGGCTATCGT -> TAGATACCAGGCTATCGTC
ATAGCACCTGCTGAACGCA -> TAGCACCTGCTGAACGCAT
ATAGCCCGATGCTCGCGAG -> TAGCCCGATGCTCGCGAGC
ATAGCCCGATTTCAAACCA -> TAGCCCGATTTCAAACCAG
ATAGGTAGCGGCGTCACGG -> TAGGTAGCGGCGTCACGGA
ATAGTAGTCGGATCCCATT -> TAGTAGTCGGATCCCATTA
ATAGTCATCCCCGATCTGT -> TAGTCATCCCCGATCTGTC
ATATACAGTAACCCCTCGG -> TATACAGTAACCCCTCGGT
ATATCGAAGACAAGCAGGC -> TATCGAAGACAAGCAGGCG
ATATGATCCTAGACAGTAT -> TATGATCCTAGACAGTATG
ATATTAATCTAAGTTGTTT -> TATTAATCTAAGTTGTTTT
ATATTAGTCACATTCATAC -> TATTAGTCACATTCATACT
ATATTTGAGTGAGGAAAGC -> TATTTGAGTGAGGAAAGCT
ATATTTTAGCCATGGGTTT -> TATTTTAGCCATGGGTTTC
ATCAAAACAGCGTTAGGAC -> TCAAAACAGCGTTAGGACG
ATCAAAAGTTACTGATAGT -> TCAAAAGTTACTGATAGTC
ATCACGGATAGCCCGATGC -> TCACGGATAGCCCGATGCT
ATCAGGCCACGAGCTGTTG -> TCAGGCCACGAGCTGTTGG
ATCAGTCGTTCAGCCCTTA -> TCAGTCGTTCAGCCCTTAT
ATCATACAATATTAGTCAC -> TCATACAATATTAGTCACA
ATCCAAATTCATACGAAGC -> TCCAAATTCATACGAAGCA
ATCCAATCAGTCGTTCAGC -> TCCAATCAGTCGTTCAGCC
ATCCCATTATGTCAACTCT -> TCCCATTATGTCAACTCTC
ATCCCCGATCTGTCCTGTA -> TCCCCGATCTGTCCTGTAT
ATCCCCTTTGCGAAGGACT -> TCCCCTTTGCGAAGGACTA
ATCCGGATCGCTTTAGTAC -> TCCGGATCGCTTTAGTACT
ATCCGGGCGTACATCATAC -> TCCGGGCGTACATCATACA
ATCCGTCCAAATGACCCCT -> TCCGTCCAAATGACCCCTT
ATCCTAGACAGTATGATGT -> TCCTAGACAGTATGATGTT
ATCGAAGACAAGCAGGCGC -> TCGAAGACAAGCAGGCGCT
ATCGAAGCCTTCTTTCATC -> TCGAAGCCTTCTTTCATCC
ATCGACCTGTGTTCGGCTC -> TCGACCTGTGTTCGGCTCC
ATCGAGGGGCTGGCGATTG -> TCGAGGGGCTGGCGATTGG
ATCGCTTTAGTACTTGCGT -> TCGCTTTAGTACTTGCGTC
ATCGGATAGGTAGCGGCGT -> TCGGATAGGTAGCGGCGTC
ATCGGGGACCATCGAAGCC -> TCGGGGACCATCGAAGCCT
ATCGGTGGTCCACGAGAAC -> TCGGTGGTCCACGAGAACA
ATCGTCCAAAATTTGGCAT -> TCGTCCAAAATTTGGCATA
ATCGTCCAACGCCCACGCC -> TCGTCCAACGCCCACGCCC
ATCGTCCAAGGGCACCCAT -> TCGTCCAAGGGCACCCATT
ATCGTCCAATTCCTATCGT -> TCGTCCAATTCCTATCGTT
ATCGTTCCCCTAACCTGAC -> TCGTTCCCCTAACCTGACA
ATCTAAGTTGTTTTTCGAT -> TCTAAGTTGTTTTTCGATC
ATCTACTCCAGTGGCCGCA -> TCTACTCCAGTGGCCGCAT
ATCTCAGCTGTCTAGTTGG -> TCTCAGCTGTCTAGTTGGT
ATCTGGAATGGTACGAGTG -> TCTGGAATGGTACGAGTGA
ATCTGGGGCGCGCGCTCTT -> TCTGGGGCGCGCGCTCTTT
ATCTGTCCTGTATAATGGG -> TCTGTCCTGTATAATGGGT
ATGAACATGCTGCCAGACT -> TGAACATGCTGCCAGACTA
ATGACCCCTTAGACCGCGT -> TGACCCCTTAGACCGCGTC
ATGATCCTAGACAGTATGA -> TGATCCTAGACAGTATGAT
ATGATGTTAACATTAGCGA -> TGATGTTAACATTAGCGAG
ATGCCACACACTGTTCGGC -> TGCCACACACTGTTCGGCA
ATGCCCGTACTAGACACTA -> TGCCCGTACTAGACACTAC
ATGCCGCACCAAGCAGTAG -> TGCCGCACCAAGCAGTAGA
ATGCCTCCCTAATTTCGCG -> TGCCTCCCTAATTTCGCGT
ATGCTAGTCGGCACTCGAG -> TGCTAGTCGGCACTCGAGG
ATGCTCGCGAGCATGGGTT -> TGCTCGCGAGCATGGGTTA
ATGCTGCCAGACTAACATA -> TGCTGCCAGACTAACATAG
ATGGGTCCGGCGGCGAGGA -> TGGGTCCGGCGGCGAGGAA
ATGGGTCTGTGTTCTGTTA -> TGGGTCTGTGTTCTGTTAT
ATGGGTTAGATTAGGTTTT -> TGGGTTAGATTAGGTTTTT
ATGGGTTTCACAACGGTTG -> TGGGTTTCACAACGGTTGC
ATGGTACGAGTGAAGTAAA -> TGGTACGAGTGAAGTAAAA
ATGTCAACTCTCTGACACT -> TGTCAACTCTCTGACACTC
ATGTCGCCCAATATGATCC -> TGTCGCCCAATATGATCCT
ATGTTAACATTAGCGAGAA -> TGTTAACATTAGCGAGAAA
ATGTTAGTTCCGGGTGGAT -> TGTTAGTTCCGGGTGGATA
ATGTTCCAACACTCGGACT -> TGTTCCAACACTCGGACTT
ATGTTCCTCGACAATTCTG -> TGTTCCTCGACAATTCTGT
ATGTTTTTAGGACATTCTC -> TGTTTTTAGGACATTCTCC
ATTAATCGGTGGTCCACGA -> TTAATCGGTGGTCCACGAG
ATTAATCTAAGTTGTTTTT -> TTAATCTAAGTTGTTTTTC
ATTAGCGAGAAATCAAAAC -> TTAGCGAGAAATCAAAACA
ATTAGGTTTTTTGAAATCT -> TTAGGTTTTTTGAAATCTG
ATTAGTCACATTCATACTT -> TTAGTCACATTCATACTTC
ATTATGTCAACTCTCTGAC -> TTATGTCAACTCTCTGACA
ATTCATACGAAGCACAGGA -> TTCATACGAAGCACAGGAG
ATTCATACTTCTGAAAACA -> TTCATACTTCTGAAAACAG
ATTCCCCTAACCTGACAGA -> TTCCCCTAACCTGACAGAG
ATTCCCTTCCGGAGCAGTT -> TTCCCTTCCGGAGCAGTTT
ATTCCTATCGTTCCCCTAA -> TTCCTATCGTTCCCCTAAC
ATTCGCCACGTCCTGTATA -> TTCGCCACGTCCTGTATAT
ATTCGCCCAAGCGTTGATC -> TTCGCCCAAGCGTTGATCG
ATTCTCCTGGACCCCCACA -> TTCTCCTGGACCCCCACAC
ATTCTGAAGCTAACAGGAC -> TTCTGAAGCTAACAGGACA
ATTCTGTTAGCCTGGGCTT -> TTCTGTTAGCCTGGGCTTA
ATTGAAAAGTTTCTTTATC -> TTGAAAAGTTTCTTTATCT
ATTGAAGAGGAGGGACTGA -> TTGAAGAGGAGGGACTGAA
ATTGAGAGTATCCAATCAG -> TTGAGAGTATCCAATCAGT
ATTGGATGCCGCACCAAGC -> TTGGATGCCGCACCAAGCA
ATTGGTGCCGCCCAATTGA -> TTGGTGCCGCCCAATTGAG
ATTTCAAACCAGCGCGTCC -> TTTCAAACCAGCGCGTCCC
ATTTCGCGTTGTCTATGTT -> TTTCGCGTTGTCTATGTTA
ATTTGAGTGAGGAAAGCTT -> TTTGAGTGAGGAAAGCTTT
ATTTGCCCCGTAGCGGTAC -> TTTGCCCCGTAGCGGTACA
ATTTGCTTTCGTAACTTAA -> TTTGCTTTCGTAACTTAAG
ATTTGGCATACCCCTAACC -> TTTGGCATACCCCTAACCT
ATTTTAGCCATGGGTTTCA -> TTTTAGCCATGGGTTTCAC
ATTTTGATATCGAAGACAA -> TTTTGATATCGAAGACAAG
CAAAACAGCGTTAGGACGA -> AAAACAGCGTTAGGACGAA
CAAAAGCCCTTTGATTCGC -> AAAAGCCCTTTGATTCGCC
CAAAAGTTACTGATAGTCA -> AAAAGTTACTGATAGTCAT
CAAAAGTTTCTATTCTGAA -> AAAAGTTTCTATTCTGAAG
CAAAATTTGGCATACCCCT -> AAAATTTGGCATACCCCTA
CAAACCAGCGCGTCCCGCC -> AAACCAGCGCGTCCCGCCT
CAAAGTTACCCCACGTTTA -> AAAGTTACCCCACGTTTAT
CAAATGACCCCTTAGACCG -> AAATGACCCCTTAGACCGC
CAAATTCATACGAAGCACA -> AAATTCATACGAAGCACAG
CAACACTCGGACTTCTCCC -> AACACTCGGACTTCTCCCC
CAACCCAGGCCCGGAAATT -> AACCCAGGCCCGGAAATTC
CAACGCCCACGCCCCCCCT -> AACGCCCACGCCCCCCCTA
CAACGGTTGCCTTAGCAGG -> AACGGTTGCCTTAGCAGGT
CAACTCTCTGACACTCGTG -> AACTCTCTGACACTCGTGG
CAACTTCCACACGAAGTAT -> AACTTCCACACGAAGTATA
CAACTTGGGGTAGTACATG -> AACTTGGGGTAGTACATGT
CAAGAAATCGAGGGGCTGG -> AAGAAATCGAGGGGCTGGC
CAAGACCAGACGTAGGGGA -> AAGACCAGACGTAGGGGAC
CAAGACGCAGACTTAACGA -> AAGACGCAGACTTAACGAA
CAAGCAGGCGCTTGCTGGG -> AAGCAGGCGCTTGCTGGGG
CAAGCAGTAGAAGTCTTCC -> AAGCAGTAGAAGTCTTCCT
CAAGCGTTGATCGACCTGT -> AAGCGTTGATCGACCTGTG
CAAGCTGACGGAACGTGCC -> AAGCTGACGGAACGTGCCG
CAAGGCGAACCAGTCGTCA -> AAGGCGAACCAGTCGTCAC
CAAGGGCACCCATTCCCCT -> AAGGGCACCCATTCCCCTA
CAAGTGGCAGGCGGCCAAG -> AAGTGGCAGGCGGCCAAGA
CAATAATTTTGATATCGAA -> AATAATTTTGATATCGAAG
CAATATGATCCTAGACAGT -> AATATGATCCTAGACAGTA
CAATATTAGTCACATTCAT -> AATATTAGTCACATTCATA
CAATCAGTCGTTCAGCCCT -> AATCAGTCGTTCAGCCCTT
CAATCCGGGCGTACATCAT -> AATCCGGGCGTACATCATA
CAATGCTAGTCGGCACTCG -> AATGCTAGTCGGCACTCGA
CAATGTTCCAACACTCGGA -> AATGTTCCAACACTCGGAC
CAATTCCTATCGTTCCCCT -> AATTCCTATCGTTCCCCTA
CAATTCTGTTAGCCTGGGC -> AATTCTGTTAGCCTGGGCT
CAATTGAAAAGTTTCTTTA -> AATTGAAAAGTTTCTTTAT
CAATTGAGAGTATCCAATC -> AATTGAGAGTATCCAATCA
CACAACGGTTGCCTTAGCA -> ACAACGGTTGCCTTAGCAG
CACACACTGTTCGGCATCC -> ACACACTGTTCGGCATCCC
CACACGAAGTATAGCCCGA -> ACACGAAGTATAGCCCGAT
CACACTGAAGACAGCCATT -> ACACTGAAGACAGCCATTT
CACACTGTTCGGCATCCCC -> ACACTGTTCGGCATCCCCT
CACAGCTCAAAGTTACCCC -> ACAGCTCAAAGTTACCCCA
CACAGCTGCACTAAAACGG -> ACAGCTGCACTAAAACGGG
CACAGGAGGATTCGCCCAA -> ACAGGAGGATTCGCCCAAG
CACAGGAGGCGTCCTCTTC -> ACAGGAGGCGTCCTCTTCC
CACATTCATACTTCTGAAA -> ACATTCATACTTCTGAAAA
CACCAAGCAGTAGAAGTCT -> ACCAAGCAGTAGAAGTCTT
CACCCAACTTGGGGTAGTA -> ACCCAACTTGGGGTAGTAC
CACCCATTCCCCTAACCTG -> ACCCATTCCCCTAACCTGA
CACCCTGGTAAGGTCAAAA -> ACCCTGGTAAGGTCAAAAG
CACCTGCTGAACGCATCCG -> ACCTGCTGAACGCATCCGG
CACGAAGTATAGCCCGATT -> ACGAAGTATAGCCCGATTT
CACGAGAACATCTACTCCA -> ACGAGAACATCTACTCCAG
CACGAGCTGTTGGCCTTCT -> ACGAGCTGTTGGCCTTCTC
CACGCCCCCCCTAACCTGA -> ACGCCCCCCCTAACCTGAC
CACGCCGAGTAAGGCCGGG -> ACGCCGAGTAAGGCCGGGC
CACGGAAGTTACCAGGCTA -> ACGGAAGTTACCAGGCTAT
CACGGATAGCCCGATGCTC -> ACGGATAGCCCGATGCTCG
CACGTCCTGTATATTTTAG -> ACGTCCTGTATATTTTAGC
CACGTTTATGCCTCCCTAA -> ACGTTTATGCCTCCCTAAT
CACTAAAACGGGAGGTCTC -> ACTAAAACGGGAGGTCTCC
CACTACCAAGAAATCGAGG -> ACTACCAAGAAATCGAGGG
CACTCGAGGGCTGCCGAGG -> ACTCGAGGGCTGCCGAGGC
CACTCGGACTTCTCCCCCA -> ACTCGGACTTCTCCCCCAC
CACTCGTGGAGCATAAGGC -> ACTCGTGGAGCATAAGGCA
CACTGAAGACAGCCATTTG -> ACTGAAGACAGCCATTTGC
CACTGGTCCCCTACGTGTT -> ACTGGTCCCCTACGTGTTT
CACTGTGAAAACCCGCCCG -> ACTGTGAAAACCCGCCCGT
CACTGTTCGGCATCCCCTT -> ACTGTTCGGCATCCCCTTT
CAGAAAGCAGCTCACAGGA -> AGAAAGCAGCTCACAGGAG
CAGACGTAGGGGACAGTAG -> AGACGTAGGGGACAGTAGC
CAGACTAACATAGATACCA -> AGACTAACATAGATACCAG
CAGACTTAACGAACTGAGT -> AGACTTAACGAACTGAGTT
CAGAGAGCTAAGTTTAACG -> AGAGAGCTAAGTTTAACGC
CAGAGCACGCCGAGTAAGG -> AGAGCACGCCGAGTAAGGC
CAGAGTACCAACCCAGGCC -> AGAGTACCAACCCAGGCCC
CAGAGTACCCAGAGAGCTA -> AGAGTACCCAGAGAGCTAA
CAGAGTAGGTCTGGTGATA -> AGAGTAGGTCTGGTGATAT
CAGAGTATCTCAGCTGTCT -> AGAGTATCTCAGCTGTCTA
CAGATGAACATGCTGCCAG -> AGATGAACATGCTGCCAGA
CAGCCATTTGCTTTCGTAA -> AGCCATTTGCTTTCGTAAC
CAGCCCTTATCCAAATTCA -> AGCCCTTATCCAAATTCAT
CAGCGCGTCCCGCCTCAGG -> AGCGCGTCCCGCCTCAGGT
CAGCGCTAGAACCCCTGTG -> AGCGCTAGAACCCCTGTGG
CAGCGTTAGGACGAACTAG -> AGCGTTAGGACGAACTAGG
CAGCTACTTTGGAGCAATG -> AGCTACTTTGGAGCAATGT
CAGCTCAAAGTTACCCCAC -> AGCTCAAAGTTACCCCACG
CAGCTCACAGGAGGCGTCC -> AGCTCACAGGAGGCGTCCT
CAGCTGCACTAAAACGGGA -> AGCTGCACTAAAACGGGAG
CAGCTGTCTAGTTGGTCAT -> AGCTGTCTAGTTGGTCATC
CAGGACATGCCCGTACTAG -> AGGACATGCCCGTACTAGA
CAGGAGGATTCGCCCAAGC -> AGGAGGATTCGCCCAAGCG
CAGGAGGCGTCCTCTTCCC -> AGGAGGCGTCCTCTTCCCG
CAGGCCACGAGCTGTTGGC -> AGGCCACGAGCTGTTGGCC
CAGGCCCGGAAATTCCCTT -> AGGCCCGGAAATTCCCTTC
CAGGCGCTTGCTGGGGCGC -> AGGCGCTTGCTGGGGCGCT
CAGGCGGCCAAGACGCAGA -> AGGCGGCCAAGACGCAGAC
CAGGCTATCGTCCAAAATT -> AGGCTATCGTCCAAAATTT
CAGGCTATCGTCCAACGCC -> AGGCTATCGTCCAACGCCC
CAGGCTATCGTCCAAGGGC -> AGGCTATCGTCCAAGGGCA
CAGGCTATCGTCCAATTCC -> AGGCTATCGTCCAATTCCT
CAGGTCTTCAGTACAGCTA -> AGGTCTTCAGTACAGCTAC
CAGGTTATTAATCGGTGGT -> AGGTTATTAATCGGTGGTC
CAGTAACCCCTCGGTCCAG -> AGTAACCCCTCGGTCCAGC
CAGTACAGCTACTTTGGAG -> AGTACAGCTACTTTGGAGC
CAGTAGAAGTCTTCCTCGA -> AGTAGAAGTCTTCCTCGAT
CAGTAGCAGATGAACATGC -> AGTAGCAGATGAACATGCT
CAGTAGTCAAGGCGAACCA -> AGTAGTCAAGGCGAACCAG
CAGTATGATGTTAACATTA -> AGTATGATGTTAACATTAG
CAGTCGTCACAGCTCAAAG -> AGTCGTCACAGCTCAAAGT
CAGTCGTTCAGCCCTTATC -> AGTCGTTCAGCCCTTATCC
CAGTGGCCGCATAGTAGTC -> AGTGGCCGCATAGTAGTCG
CAGTGGCGCATAATACCAT -> AGTGGCGCATAATACCATA
CAGTTTAGACATCAGGCCA -> AGTTTAGACATCAGGCCAC
CATAAGGCACTGGTCCCCT -> ATAAGGCACTGGTCCCCTA
CATAATACCATAGCACCTG -> ATAATACCATAGCACCTGC
CATACAATATTAGTCACAT -> ATACAATATTAGTCACATT
CATACCCCTAACCTGACAG -> ATACCCCTAACCTGACAGA
CATACGAAGCACAGGAGGA -> ATACGAAGCACAGGAGGAT
CATACTTCTGAAAACAGAG -> ATACTTCTGAAAACAGAGC
CATAGATACCAGGCTATCG -> ATAGATACCAGGCTATCGT
CATAGCACCTGCTGAACGC -> ATAGCACCTGCTGAACGCA
CATAGTAGTCGGATCCCAT -> ATAGTAGTCGGATCCCATT
CATCAGGCCACGAGCTGTT -> ATCAGGCCACGAGCTGTTG
CATCATACAATATTAGTCA -> ATCATACAATATTAGTCAC
CATCCCCGATCTGTCCTGT -> ATCCCCGATCTGTCCTGTA
CATCCCCTTTGCGAAGGAC -> ATCCCCTTTGCGAAGGACT
CATCCGGATCGCTTTAGTA -> ATCCGGATCGCTTTAGTAC
CATCCGTCCAAATGACCCC -> ATCCGTCCAAATGACCCCT
CATCGAAGCCTTCTTTCAT -> ATCGAAGCCTTCTTTCATC
CATCGGATAGGTAGCGGCG -> ATCGGATAGGTAGCGGCGT
CATCTACTCCAGTGGCCGC -> ATCTACTCCAGTGGCCGCA
CATGCCACACACTGTTCGG -> ATGCCACACACTGTTCGGC
CATGCCCGTACTAGACACT -> ATGCCCGTACTAGACACTA
CATGCTGCCAGACTAACAT -> ATGCTGCCAGACTAACATA
CATGGGTCTGTGTTCTGTT -> ATGGGTCTGTGTTCTGTTA
CATGGGTTAGATTAGGTTT -> ATGGGTTAGATTAGGTTTT
CATGGGTTTCACAACGGTT -> ATGGGTTTCACAACGGTTG
CATGTTTTTAGGACATTCT -> ATGTTTTTAGGACATTCTC
CATTAGCGAGAAATCAAAA -> ATTAGCGAGAAATCAAAAC
CATTATGTCAACTCTCTGA -> ATTATGTCAACTCTCTGAC
CATTCATACTTCTGAAAAC -> ATTCATACTTCTGAAAACA
CATTCCCCTAACCTGACAG -> ATTCCCCTAACCTGACAGA
CATTCTCCTGGACCCCCAC -> ATTCTCCTGGACCCCCACA
CATTTGCTTTCGTAACTTA -> ATTTGCTTTCGTAACTTAA
CCAAAAGCCCTTTGATTCG -> CAAAAGCCCTTTGATTCGC
CCAAAATTTGGCATACCCC -> CAAAATTTGGCATACCCCT
CCAAATGACCCCTTAGACC -> CAAATGACCCCTTAGACCG
CCAAATTCATACGAAGCAC -> CAAATTCATACGAAGCACA
CCAACACTCGGACTTCTCC -> CAACACTCGGACTTCTCCC
CCAACCCAGGCCCGGAAAT -> CAACCCAGGCCCGGAAATT
CCAACGCCCACGCCCCCCC -> CAACGCCCACGCCCCCCCT
CCAACTTGGGGTAGTACAT -> CAACTTGGGGTAGTACATG
CCAAGAAATCGAGGGGCTG -> CAAGAAATCGAGGGGCTGG
CCAAGACGCAGACTTAACG -> CAAGACGCAGACTTAACGA
CCAAGCAGTAGAAGTCTTC -> CAAGCAGTAGAAGTCTTCC
CCAAGCGTTGATCGACCTG -> CAAGCGTTGATCGACCTGT
CCAAGCTGACGGAACGTGC -> CAAGCTGACGGAACGTGCC
CCAAGGGCACCCATTCCCC -> CAAGGGCACCCATTCCCCT
CCAAGTGGCAGGCGGCCAA -> CAAGTGGCAGGCGGCCAAG
CCAATAATTTTGATATCGA -> CAATAATTTTGATATCGAA
CCAATATGATCCTAGACAG -> CAATATGATCCTAGACAGT
CCAATCAGTCGTTCAGCCC -> CAATCAGTCGTTCAGCCCT
CCAATTCCTATCGTTCCCC -> CAATTCCTATCGTTCCCCT
CCAATTGAGAGTATCCAAT -> CAATTGAGAGTATCCAATC
CCACACACTGTTCGGCATC -> CACACACTGTTCGGCATCC
CCACACGAAGTATAGCCCG -> CACACGAAGTATAGCCCGA
CCACACTGAAGACAGCCAT -> CACACTGAAGACAGCCATT
CCACCCAACTTGGGGTAGT -> CACCCAACTTGGGGTAGTA
CCACGAGAACATCTACTCC -> CACGAGAACATCTACTCCA
CCACGAGCTGTTGGCCTTC -> CACGAGCTGTTGGCCTTCT
CCACGCCCCCCCTAACCTG -> CACGCCCCCCCTAACCTGA
CCACGTCCTGTATATTTTA -> CACGTCCTGTATATTTTAG
CCACGTTTATGCCTCCCTA -> CACGTTTATGCCTCCCTAA
CCAGACGTAGGGGACAGTA -> CAGACGTAGGGGACAGTAG
CCAGACTAACATAGATACC -> CAGACTAACATAGATACCA
CCAGAGAGCTAAGTTTAAC -> CAGAGAGCTAAGTTTAACG
CCAGCGCGTCCCGCCTCAG -> CAGCGCGTCCCGCCTCAGG
CCAGCGCTAGAACCCCTGT -> CAGCGCTAGAACCCCTGTG
CCAGGCCCGGAAATTCCCT -> CAGGCCCGGAAATTCCCTT
CCAGGCTATCGTCCAAAAT -> CAGGCTATCGTCCAAAATT
CCAGGCTATCGTCCAACGC -> CAGGCTATCGTCCAACGCC
CCAGGCTATCGTCCAAGGG -> CAGGCTATCGTCCAAGGGC
CCAGGCTATCGTCCAATTC -> CAGGCTATCGTCCAATTCC
CCAGTCGTCACAGCTCAAA -> CAGTCGTCACAGCTCAAAG
CCAGTGGCCGCATAGTAGT -> CAGTGGCCGCATAGTAGTC
CCAGTGGCGCATAATACCA -> CAGTGGCGCATAATACCAT
CCATAGCACCTGCTGAACG -> CATAGCACCTGCTGAACGC
CCATCGAAGCCTTCTTTCA -> CATCGAAGCCTTCTTTCAT
CCATGCCACACACTGTTCG -> CATGCCACACACTGTTCGG
CCATGGGTTTCACAACGGT -> CATGGGTTTCACAACGGTT
CCATTATGTCAACTCTCTG -> CATTATGTCAACTCTCTGA
CCATTCCCCTAACCTGACA -> CATTCCCCTAACCTGACAG
CCATTTGCTTTCGTAACTT -> CATTTGCTTTCGTAACTTA
CCCAACTTGGGGTAGTACA -> CCAACTTGGGGTAGTACAT
CCCAAGCGTTGATCGACCT -> CCAAGCGTTGATCGACCTG
CCCAATATGATCCTAGACA -> CCAATATGATCCTAGACAG
CCCAATTGAGAGTATCCAA -> CCAATTGAGAGTATCCAAT
CCCACACTGAAGACAGCCA -> CCACACTGAAGACAGCCAT
CCCACCCAACTTGGGGTAG -> CCACCCAACTTGGGGTAGT
CCCACGCCCCCCCTAACCT -> CCACGCCCCCCCTAACCTG
CCCACGTTTATGCCTCCCT -> CCACGTTTATGCCTCCCTA
CCCAGAGAGCTAAGTTTAA -> CCAGAGAGCTAAGTTTAAC
CCCAGGCCCGGAAATTCCC -> CCAGGCCCGGAAATTCCCT
CCCATTATGTCAACTCTCT -> CCATTATGTCAACTCTCTG
CCCATTCCCCTAACCTGAC -> CCATTCCCCTAACCTGACA
CCCCACACTGAAGACAGCC -> CCCACACTGAAGACAGCCA
CCCCACCCAACTTGGGGTA -> CCCACCCAACTTGGGGTAG
CCCCACGTTTATGCCTCCC -> CCCACGTTTATGCCTCCCT
CCCCCACACTGAAGACAGC -> CCCCACACTGAAGACAGCC
CCCCCACCCAACTTGGGGT -> CCCCACCCAACTTGGGGTA
CCCCCCCTAACCTGACAGA -> CCCCCCTAACCTGACAGAG
CCCCCCTAACCTGACAGAG -> CCCCCTAACCTGACAGAGT
CCCCCTAACCTGACAGAGT -> CCCCTAACCTGACAGAGTA
CCCCGATCTGTCCTGTATA -> CCCGATCTGTCCTGTATAA
CCCCGTAGCGGTACACCCT -> CCCGTAGCGGTACACCCTG
CCCCTAACCTGACAGAGTA -> CCCTAACCTGACAGAGTAC,CCCTAACCTGACAGAGTAC,CCCTAACCTGACAGAGTAG,CCCTAACCTGACAGAGTAT
CCCCTACATGGGTCTGTGT -> CCCTACATGGGTCTGTGTT
CCCCTACGTGTTTCGGTGT -> CCCTACGTGTTTCGGTGTG
CCCCTCGGTCCAGCGCTAG -> CCCTCGGTCCAGCGCTAGA
CCCCTGTGGCAGAAAGCAG -> CCCTGTGGCAGAAAGCAGC
CCCCTTAGACCGCGTCAAT -> CCCTTAGACCGCGTCAATT
CCCCTTTGCGAAGGACTAG -> CCCTTTGCGAAGGACTAGG
CCCGATCTGTCCTGTATAA -> CCGATCTGTCCTGTATAAT
CCCGATGCTCGCGAGCATG -> CCGATGCTCGCGAGCATGG
CCCGATTTCAAACCAGCGC -> CCGATTTCAAACCAGCGCG
CCCGCCCGTGACCAAGCTG -> CCGCCCGTGACCAAGCTGA
CCCGCCTCAGGTCTTCAGT -> CCGCCTCAGGTCTTCAGTA
CCCGGAAATTCCCTTCCGG -> CCGGAAATTCCCTTCCGGA
CCCGTACTAGACACTACCA -> CCGTACTAGACACTACCAA
CCCGTAGCGGTACACCCTG -> CCGTAGCGGTACACCCTGG
CCCGTGACCAAGCTGACGG -> CCGTGACCAAGCTGACGGA
CCCGTGGTTTCGCGGGCTA -> CCGTGGTTTCGCGGGCTAA
CCCTAACCTGACAGAGTAC -> CCTAACCTGACAGAGTACC,CCTAACCTGACAGAGTACC
CCCTAACCTGACAGAGTAG -> CCTAACCTGACAGAGTAGG
CCCTAACCTGACAGAGTAT -> CCTAACCTGACAGAGTATC
CCCTAATTTCGCGTTGTCT -> CCTAATTTCGCGTTGTCTA
CCCTACATGGGTCTGTGTT -> CCTACATGGGTCTGTGTTC
CCCTACGTGTTTCGGTGTG -> CCTACGTGTTTCGGTGTGC
CCCTCGGTCCAGCGCTAGA -> CCTCGGTCCAGCGCTAGAA
CCCTGGGAACAACTTCCAC -> CCTGGGAACAACTTCCACA
CCCTGGTAAGGTCAAAAGT -> CCTGGTAAGGTCAAAAGTT
CCCTGTGGCAGAAAGCAGC -> CCTGTGGCAGAAAGCAGCT
CCCTTAGACCGCGTCAATT -> CCTTAGACCGCGTCAATTG
CCCTTATCCAAATTCATAC -> CCTTATCCAAATTCATACG
CCCTTCCGGAGCAGTTTAG -> CCTTCCGGAGCAGTTTAGA
CCCTTTGATTCGCCACGTC -> CCTTTGATTCGCCACGTCC
CCCTTTGCGAAGGACTAGG -> CCTTTGCGAAGGACTAGGT
CCGAAGTTGTTGTTAAGGG -> CGAAGTTGTTGTTAAGGGT
CCGACTCTACCAGGCTATC -> CGACTCTACCAGGCTATCG
CCGAGGCCTCTCGCAACCT -> CGAGGCCTCTCGCAACCTC
CCGAGTAAGGCCGGGCACT -> CGAGTAAGGCCGGGCACTG
CCGATCTGTCCTGTATAAT -> CGATCTGTCCTGTATAATG
CCGATGCTCGCGAGCATGG -> CGATGCTCGCGAGCATGGG
CCGATTTCAAACCAGCGCG -> CGATTTCAAACCAGCGCGT
CCGCACCAAGCAGTAGAAG -> CGCACCAAGCAGTAGAAGT
CCGCATAGTAGTCGGATCC -> CGCATAGTAGTCGGATCCC
CCGCCCAATTGAGAGTATC -> CGCCCAATTGAGAGTATCC
CCGCCCGTGACCAAGCTGA -> CGCCCGTGACCAAGCTGAC
CCGCCTCAGGTCTTCAGTA -> CGCCTCAGGTCTTCAGTAC
CCGCGGAACTAGGTCGCTA -> CGCGGAACTAGGTCGCTAC
CCGCGTCAATTGAAAAGTT -> CGCGTCAATTGAAAAGTTT
CCGGAAATTCCCTTCCGGA -> CGGAAATTCCCTTCCGGAG
CCGGAGCAGTTTAGACATC -> CGGAGCAGTTTAGACATCA
CCGGATCGCTTTAGTACTT -> CGGATCGCTTTAGTACTTG
CCGGCGGCGAGGAAGATCA -> CGGCGGCGAGGAAGATCAC
CCGGGCACTGTGAAAACCC -> CGGGCACTGTGAAAACCCG
CCGGGCGTACATCATACAA -> CGGGCGTACATCATACAAT
CCGGGTGGATAAGGTGAGA -> CGGGTGGATAAGGTGAGAT
CCGTACTAGACACTACCAA -> CGTACTAGACACTACCAAG
CCGTAGCGGTACACCCTGG -> CGTAGCGGTACACCCTGGT
CCGTCCAAATGACCCCTTA -> CGTCCAAATGACCCCTTAG
CCGTGACCAAGCTGACGGA -> CGTGACCAAGCTGACGGAA
CCGTGGTTTCGCGGGCTAA -> CGTGGTTTCGCGGGCTAAC
CCTAACCTGACAGAGTACC -> CTAACCTGACAGAGTACCA,CTAACCTGACAGAGTACCC
CCTAACCTGACAGAGTAGG -> CTAACCTGACAGAGTAGGT
CCTAACCTGACAGAGTATC -> CTAACCTGACAGAGTATCT
CCTAATTTCGCGTTGTCTA -> CTAATTTCGCGTTGTCTAT
CCTACATGGGTCTGTGTTC -> CTACATGGGTCTGTGTTCT
CCTACGCCCTGGGAACAAC -> CTACGCCCTGGGAACAACT
CCTACGTGTTTCGGTGTGC -> CTACGTGTTTCGGTGTGCG
CCTAGACAGTATGATGTTA -> CTAGACAGTATGATGTTAA
CCTAGGCAAGACCAGACGT -> CTAGGCAAGACCAGACGTA
CCTATCGTTCCCCTAACCT -> CTATCGTTCCCCTAACCTG
CCTATGTTCCTCGACAATT -> CTATGTTCCTCGACAATTC
CCTCAGGTCTTCAGTACAG -> CTCAGGTCTTCAGTACAGC
CCTCCCTAATTTCGCGTTG -> CTCCCTAATTTCGCGTTGT
CCTCGACAATTCTGTTAGC -> CTCGACAATTCTGTTAGCC
CCTCGATCGGGGACCATCG -> CTCGATCGGGGACCATCGA
CCTCGGTCCAGCGCTAGAA -> CTCGGTCCAGCGCTAGAAC
CCTCTCGCAACCTCAAGAT -> CTCTCGCAACCTCAAGATG
CCTCTTCCCGTGGTTTCGC -> CTCTTCCCGTGGTTTCGCG
CCTGACAGAGTACCAACCC -> CTGACAGAGTACCAACCCA
CCTGACAGAGTACCCAGAG -> CTGACAGAGTACCCAGAGA
CCTGACAGAGTAGGTCTGG -> CTGACAGAGTAGGTCTGGT
CCTGACAGAGTATCTCAGC -> CTGACAGAGTATCTCAGCT
CCTGCTGAACGCATCCGGA -> CTGCTGAACGCATCCGGAT
CCTGGACCCCCACACTGAA -> CTGGACCCCCACACTGAAG
CCTGGGAACAACTTCCACA -> CTGGGAACAACTTCCACAC
CCTGGGCTTACTACGTATA -> CTGGGCTTACTACGTATAA
CCTGGTAAGGTCAAAAGTT -> CTGGTAAGGTCAAAAGTTT
CCTGTATAATGGGTCCGGC -> CTGTATAATGGGTCCGGCG
CCTGTATATTTTAGCCATG -> CTGTATATTTTAGCCATGG
CCTGTGGCAGAAAGCAGCT -> CTGTGGCAGAAAGCAGCTC
CCTGTGTTCGGCTCCCCTA -> CTGTGTTCGGCTCCCCTAC
CCTTAGACCGCGTCAATTG -> CTTAGACCGCGTCAATTGA
CCTTAGCAGGTTATTAATC -> CTTAGCAGGTTATTAATCG
CCTTATCCAAATTCATACG -> CTTATCCAAATTCATACGA
CCTTCCGGAGCAGTTTAGA -> CTTCCGGAGCAGTTTAGAC
CCTTCTCCATGCCACACAC -> CTTCTCCATGCCACACACT
CCTTCTTTCATCCGTCCAA -> CTTCTTTCATCCGTCCAAA
CCTTTGATTCGCCACGTCC -> CTTTGATTCGCCACGTCCT
CCTTTGCGAAGGACTAGGT -> CTTTGCGAAGGACTAGGTG
CGAACCAGTCGTCACAGCT -> GAACCAGTCGTCACAGCTC
CGAACTAGGGGCCTAGGCA -> GAACTAGGGGCCTAGGCAA
CGAACTGAGTTTTCTACGC -> GAACTGAGTTTTCTACGCT
CGAAGACAAGCAGGCGCTT -> GAAGACAAGCAGGCGCTTG
CGAAGCACAGGAGGATTCG -> GAAGCACAGGAGGATTCGC
CGAAGCCTTCTTTCATCCG -> GAAGCCTTCTTTCATCCGT
CGAAGGACTAGGTGAGTGT -> GAAGGACTAGGTGAGTGTG
CGAAGTATAGCCCGATTTC -> GAAGTATAGCCCGATTTCA
CGAAGTTGTTGTTAAGGGT -> GAAGTTGTTGTTAAGGGTA
CGACAATTCTGTTAGCCTG -> GACAATTCTGTTAGCCTGG
CGACCGCGGAACTAGGTCG -> GACCGCGGAACTAGGTCGC
CGACCTGTGTTCGGCTCCC -> GACCTGTGTTCGGCTCCCC
CGACTCTACCAGGCTATCG -> GACTCTACCAGGCTATCGT
CGAGAAATCAAAACAGCGT -> GAGAAATCAAAACAGCGTT
CGAGAACATCTACTCCAGT -> GAGAACATCTACTCCAGTG
CGAGCATGGGTTAGATTAG -> GAGCATGGGTTAGATTAGG
CGAGCTGTTGGCCTTCTCC -> GAGCTGTTGGCCTTCTCCA
CGAGGAAGATCACGGATAG -> GAGGAAGATCACGGATAGC
CGAGGCCTCTCGCAACCTC -> GAGGCCTCTCGCAACCTCA
CGAGGGCTGCCGAGGCCTC -> GAGGGCTGCCGAGGCCTCT
CGAGGGGCTGGCGATTGGA -> GAGGGGCTGGCGATTGGAT
CGAGTAAGGCCGGGCACTG -> GAGTAAGGCCGGGCACTGT
CGAGTGAAGTAAAATTGGT -> GAGTGAAGTAAAATTGGTG
CGATATTAATCTAAGTTGT -> GATATTAATCTAAGTTGTT
CGATCAAAAGTTACTGATA -> GATCAAAAGTTACTGATAG
CGATCGGGGACCATCGAAG -> GATCGGGGACCATCGAAGC
CGATCTGTCCTGTATAATG -> GATCTGTCCTGTATAATGG
CGATGCTCGCGAGCATGGG -> GATGCTCGCGAGCATGGGT
CGATTGGATGCCGCACCAA -> GATTGGATGCCGCACCAAG
CGATTTCAAACCAGCGCGT -> GATTTCAAACCAGCGCGTC
CGCACCAAGCAGTAGAAGT -> GCACCAAGCAGTAGAAGTC
CGCAGACTTAACGAACTGA -> GCAGACTTAACGAACTGAG
CGCAGTAGTCAAGGCGAAC -> GCAGTAGTCAAGGCGAACC
CGCATAATACCATAGCACC -> GCATAATACCATAGCACCT
CGCATAGTAGTCGGATCCC -> GCATAGTAGTCGGATCCCA
CGCATCCGGATCGCTTTAG -> GCATCCGGATCGCTTTAGT
CGCCAATAATTTTGATATC -> GCCAATAATTTTGATATCG
CGCCACGTCCTGTATATTT -> GCCACGTCCTGTATATTTT
CGCCCAAGCGTTGATCGAC -> GCCCAAGCGTTGATCGACC
CGCCCAATATGATCCTAGA -> GCCCAATATGATCCTAGAC
CGCCCAATTGAGAGTATCC -> GCCCAATTGAGAGTATCCA
CGCCCACGCCCCCCCTAAC -> GCCCACGCCCCCCCTAACC
CGCCCCCCCTAACCTGACA -> GCCCCCCCTAACCTGACAG
CGCCCGTGACCAAGCTGAC -> GCCCGTGACCAAGCTGACG
CGCCCTGGGAACAACTTCC -> GCCCTGGGAACAACTTCCA
CGCCGAGTAAGGCCGGGCA -> GCCGAGTAAGGCCGGGCAC
CGCCTCAGGTCTTCAGTAC -> GCCTCAGGTCTTCAGTACA
CGCGACCGCGGAACTAGGT -> GCGACCGCGGAACTAGGTC
CGCGAGCATGGGTTAGATT -> GCGAGCATGGGTTAGATTA
CGCGCGCTCTTTGAAGTTA -> GCGCGCTCTTTGAAGTTAC
CGCGCTCTTTGAAGTTACA -> GCGCTCTTTGAAGTTACAA
CGCGGAACTAGGTCGCTAC -> GCGGAACTAGGTCGCTACG
CGCGGGCTAACGCAGTAGT -> GCGGGCTAACGCAGTAGTC
CGCGTCAATGCTAGTCGGC -> GCGTCAATGCTAGTCGGCA
CGCGTCAATTGAAAAGTTT -> GCGTCAATTGAAAAGTTTC
CGCGTCCCGCCTCAGGTCT -> GCGTCCCGCCTCAGGTCTT
CGCGTTGTCTATGTTAGTT -> GCGTTGTCTATGTTAGTTC
CGCTAAGAGGGTCGTACCT -> GCTAAGAGGGTCGTACCTA
CGCTACGCGTCAATGCTAG -> GCTACGCGTCAATGCTAGT
CGCTAGAACCCCTGTGGCA -> GCTAGAACCCCTGTGGCAG
CGCTCGTCACAGCTGCACT -> GCTCGTCACAGCTGCACTA
CGCTCTTTGAAGTTACAAT -> GCTCTTTGAAGTTACAATC
CGCTGGGGTACCAGGCTAT -> GCTGGGGTACCAGGCTATC
CGCTTGCTGGGGCGCTCGT -> GCTTGCTGGGGCGCTCGTC
CGCTTTAGTACTTGCGTCC -> GCTTTAGTACTTGCGTCCA
CGGAAATTCCCTTCCGGAG -> GGAAATTCCCTTCCGGAGC
CGGAACGTGCCGACTCTAC -> GGAACGTGCCGACTCTACC
CGGAACTAGGTCGCTACGC -> GGAACTAGGTCGCTACGCG
CGGAAGTTACCAGGCTATC -> GGAAGTTACCAGGCTATCG
CGGACCAGTGGCGCATAAT -> GGACCAGTGGCGCATAATA
CGGACTTCTCCCCCACCCA -> GGACTTCTCCCCCACCCAA
CGGAGCAGTTTAGACATCA -> GGAGCAGTTTAGACATCAG
CGGATAGCCCGATGCTCGC -> GGATAGCCCGATGCTCGCG
CGGATAGGTAGCGGCGTCA -> GGATAGGTAGCGGCGTCAC
CGGATCCCATTATGTCAAC -> GGATCCCATTATGTCAACT
CGGATCGCTTTAGTACTTG -> GGATCGCTTTAGTACTTGC
CGGCACTCGAGGGCTGCCG -> GGCACTCGAGGGCTGCCGA
CGGCATCCCCTTTGCGAAG -> GGCATCCCCTTTGCGAAGG
CGGCCAAGACGCAGACTTA -> GGCCAAGACGCAGACTTAA
CGGCGAGGAAGATCACGGA -> GGCGAGGAAGATCACGGAT
CGGCGGCGAGGAAGATCAC -> GGCGGCGAGGAAGATCACG
CGGCGTCACGGAAGTTACC -> GGCGTCACGGAAGTTACCA
CGGCTCCCCTACATGGGTC -> GGCTCCCCTACATGGGTCT
CGGGAGGTCTCCTACGCCC -> GGGAGGTCTCCTACGCCCT
CGGGCACTGTGAAAACCCG -> GGGCACTGTGAAAACCCGC
CGGGCGTACATCATACAAT -> GGGCGTACATCATACAATA
CGGGCTAACGCAGTAGTCA -> GGGCTAACGCAGTAGTCAA
CGGGGACCATCGAAGCCTT -> GGGGACCATCGAAGCCTTC
CGGGTGGATAAGGTGAGAT -> GGGTGGATAAGGTGAGATT
CGGTACACCCTGGTAAGGT -> GGTACACCCTGGTAAGGTC
CGGTCCAGCGCTAGAACCC -> GGTCCAGCGCTAGAACCCC
CGGTGGTCCACGAGAACAT -> GGTGGTCCACGAGAACATC
CGGTGTGCGCGACCGCGGA -> GGTGTGCGCGACCGCGGAA
CGGTTGCCTTAGCAGGTTA -> GGTTGCCTTAGCAGGTTAT
CGTAACTTAAGTCCAAAAG -> GTAACTTAAGTCCAAAAGC
CGTACATCATACAATATTA -> GTACATCATACAATATTAG
CGTACCTATGTTCCTCGAC -> GTACCTATGTTCCTCGACA
CGTACTAGACACTACCAAG -> GTACTAGACACTACCAAGA
CGTAGCGGTACACCCTGGT -> GTAGCGGTACACCCTGGTA
CGTAGGGGACAGTAGCAGA -> GTAGGGGACAGTAGCAGAT
CGTATAAAATGTCGCCCAA -> GTATAAAATGTCGCCCAAT
CGTCAATGCTAGTCGGCAC -> GTCAATGCTAGTCGGCACT
CGTCAATTGAAAAGTTTCT -> GTCAATTGAAAAGTTTCTT
CGTCACAGCTCAAAGTTAC -> GTCACAGCTCAAAGTTACC
CGTCACAGCTGCACTAAAA -> GTCACAGCTGCACTAAAAC
CGTCACGGAAGTTACCAGG -> GTCACGGAAGTTACCAGGC
CGTCCAAAATTTGGCATAC -> GTCCAAAATTTGGCATACC
CGTCCAAATGACCCCTTAG -> GTCCAAATGACCCCTTAGA
CGTCCAACGCCCACGCCCC -> GTCCAACGCCCACGCCCCC
CGTCCAAGGGCACCCATTC -> GTCCAAGGGCACCCATTCC
CGTCCAAGTGGCAGGCGGC -> GTCCAAGTGGCAGGCGGCC
CGTCCAATTCCTATCGTTC -> GTCCAATTCCTATCGTTCC
CGTCCCGCCTCAGGTCTTC -> GTCCCGCCTCAGGTCTTCA
CGTCCTCTTCCCGTGGTTT -> GTCCTCTTCCCGTGGTTTC
CGTCCTGTATATTTTAGCC -> GTCCTGTATATTTTAGCCA
CGTGACCAAGCTGACGGAA -> GTGACCAAGCTGACGGAAC
CGTGCCGACTCTACCAGGC -> GTGCCGACTCTACCAGGCT
CGTGGAGCATAAGGCACTG -> GTGGAGCATAAGGCACTGG
CGTGGTTTCGCGGGCTAAC -> GTGGTTTCGCGGGCTAACG
CGTGTTTCGGTGTGCGCGA -> GTGTTTCGGTGTGCGCGAC
CGTTAGGACGAACTAGGGG -> GTTAGGACGAACTAGGGGC
CGTTCAGCCCTTATCCAAA -> GTTCAGCCCTTATCCAAAT
CGTTCCCCTAACCTGACAG -> GTTCCCCTAACCTGACAGA
CGTTGATCGACCTGTGTTC -> GTTGATCGACCTGTGTTCG
CGTTGTCTATGTTAGTTCC -> GTTGTCTATGTTAGTTCCG
CGTTTATGCCTCCCTAATT -> GTTTATGCCTCCCTAATTT
CTAAAACGGGAGGTCTCCT -> TAAAACGGGAGGTCTCCTA
CTAACAGGACATGCCCGTA -> TAACAGGACATGCCCGTAC
CTAACATAGATACCAGGCT -> TAACATAGATACCAGGCTA
CTAACCTGACAGAGTACCA -> TAACCTGACAGAGTACCAA
CTAACCTGACAGAGTACCC -> TAACCTGACAGAGTACCCA
CTAACCTGACAGAGTAGGT -> TAACCTGACAGAGTAGGTC
CTAACCTGACAGAGTATCT -> TAACCTGACAGAGTATCTC
CTAACGCAGTAGTCAAGGC -> TAACGCAGTAGTCAAGGCG
CTAAGAGGGTCGTACCTAT -> TAAGAGGGTCGTACCTATG
CTAAGTTGTTTTTCGATCA -> TAAGTTGTTTTTCGATCAA
CTAAGTTTAACGCCAATAA -> TAAGTTTAACGCCAATAAT
CTAATTTCGCGTTGTCTAT -> TAATTTCGCGTTGTCTATG
CTACATGGGTCTGTGTTCT -> TACATGGGTCTGTGTTCTG
CTACCAAGAAATCGAGGGG -> TACCAAGAAATCGAGGGGC
CTACCAGGCTATCGTCCAA -> TACCAGGCTATCGTCCAAC
CTACGCCCTGGGAACAACT -> TACGCCCTGGGAACAACTT
CTACGCGTCAATGCTAGTC -> TACGCGTCAATGCTAGTCG
CTACGCTAAGAGGGTCGTA -> TACGCTAAGAGGGTCGTAC
CTACGTATAAAATGTCGCC -> TACGTATAAAATGTCGCCC
CTACGTGTTTCGGTGTGCG -> TACGTGTTTCGGTGTGCGC
CTACTCCAGTGGCCGCATA -> TACTCCAGTGGCCGCATAG
CTACTTTGGAGCAATGTTC -> TACTTTGGAGCAATGTTCC
CTAGAACCCCTGTGGCAGA -> TAGAACCCCTGTGGCAGAA
CTAGACACTACCAAGAAAT -> TAGACACTACCAAGAAATC
CTAGACAGTATGATGTTAA -> TAGACAGTATGATGTTAAC
CTAGGCAAGACCAGACGTA -> TAGGCAAGACCAGACGTAG
CTAGGGGCCTAGGCAAGAC -> TAGGGGCCTAGGCAAGACC
CTAGGTCGCTACGCGTCAA -> TAGGTCGCTACGCGTCAAT
CTAGGTGAGTGTGAATACC -> TAGGTGAGTGTGAATACCG
CTAGTCGGCACTCGAGGGC -> TAGTCGGCACTCGAGGGCT
CTAGTTGGTCATCGGATAG -> TAGTTGGTCATCGGATAGG
CTATCGTCCAAAATTTGGC -> TATCGTCCAAAATTTGGCA
CTATCGTCCAACGCCCACG -> TATCGTCCAACGCCCACGC
CTATCGTCCAAGGGCACCC -> TATCGTCCAAGGGCACCCA
CTATCGTCCAATTCCTATC -> TATCGTCCAATTCCTATCG
CTATCGTTCCCCTAACCTG -> TATCGTTCCCCTAACCTGA
CTATGTTAGTTCCGGGTGG -> TATGTTAGTTCCGGGTGGA
CTATGTTCCTCGACAATTC -> TATGTTCCTCGACAATTCT
CTATTCTGAAGCTAACAGG -> TATTCTGAAGCTAACAGGA
CTCAAAGTTACCCCACGTT -> TCAAAGTTACCCCACGTTT
CTCACAGGAGGCGTCCTCT -> TCACAGGAGGCGTCCTCTT
CTCAGCTGTCTAGTTGGTC -> TCAGCTGTCTAGTTGGTCA
CTCAGGTCTTCAGTACAGC -> TCAGGTCTTCAGTACAGCT
CTCCAGTGGCCGCATAGTA -> TCCAGTGGCCGCATAGTAG
CTCCATGCCACACACTGTT -> TCCATGCCACACACTGTTC
CTCCCCCACCCAACTTGGG -> TCCCCCACCCAACTTGGGG
CTCCCCTACATGGGTCTGT -> TCCCCTACATGGGTCTGTG
CTCCCTAATTTCGCGTTGT -> TCCCTAATTTCGCGTTGTC
CTCCTACGCCCTGGGAACA -> TCCTACGCCCTGGGAACAA
CTCCTGGACCCCCACACTG -> TCCTGGACCCCCACACTGA
CTCGACAATTCTGTTAGCC -> TCGACAATTCTGTTAGCCT
CTCGAGGGCTGCCGAGGCC -> TCGAGGGCTGCCGAGGCCT
CTCGATCGGGGACCATCGA -> TCGATCGGGGACCATCGAA
CTCGCAACCTCAAGATGGT -> TCGCAACCTCAAGATGGTA
CTCGCGAGCATGGGTTAGA -> TCGCGAGCATGGGTTAGAT
CTCGGACTTCTCCCCCACC -> TCGGACTTCTCCCCCACCC
CTCGGTCCAGCGCTAGAAC -> TCGGTCCAGCGCTAGAACC
CTCGTCACAGCTGCACTAA -> TCGTCACAGCTGCACTAAA
CTCGTGGAGCATAAGGCAC -> TCGTGGAGCATAAGGCACT
CTCTACCAGGCTATCGTCC -> TCTACCAGGCTATCGTCCA
CTCTCGCAACCTCAAGATG -> TCTCGCAACCTCAAGATGG
CTCTCTGACACTCGTGGAG -> TCTCTGACACTCGTGGAGC
CTCTGACACTCGTGGAGCA -> TCTGACACTCGTGGAGCAT
CTCTTCCCGTGGTTTCGCG -> TCTTCCCGTGGTTTCGCGG
CTCTTTGAAGTTACAATCC -> TCTTTGAAGTTACAATCCG
CTGAAAACAGAGCACGCCG -> TGAAAACAGAGCACGCCGA
CTGAACGCATCCGGATCGC -> TGAACGCATCCGGATCGCT
CTGAAGACAGCCATTTGCT -> TGAAGACAGCCATTTGCTT
CTGAAGCTAACAGGACATG -> TGAAGCTAACAGGACATGC
CTGAAGGCTGGAGCGATAT -> TGAAGGCTGGAGCGATATT
CTGACACTCGTGGAGCATA -> TGACACTCGTGGAGCATAA
CTGACAGAGTACCAACCCA -> TGACAGAGTACCAACCCAG
CTGACAGAGTACCCAGAGA -> TGACAGAGTACCCAGAGAG
CTGACAGAGTAGGTCTGGT -> TGACAGAGTAGGTCTGGTG
CTGACAGAGTATCTCAGCT -> TGACAGAGTATCTCAGCTG
CTGACGGAACGTGCCGACT -> TGACGGAACGTGCCGACTC
CTGAGTTTTCTACGCTAAG -> TGAGTTTTCTACGCTAAGA
CTGATAGTCATCCCCGATC -> TGATAGTCATCCCCGATCT
CTGCACTAAAACGGGAGGT -> TGCACTAAAACGGGAGGTC
CTGCCAGACTAACATAGAT -> TGCCAGACTAACATAGATA
CTGCCGAGGCCTCTCGCAA -> TGCCGAGGCCTCTCGCAAC
CTGCTGAACGCATCCGGAT -> TGCTGAACGCATCCGGATC
CTGGAATGGTACGAGTGAA -> TGGAATGGTACGAGTGAAG
CTGGACCCCCACACTGAAG -> TGGACCCCCACACTGAAGA
CTGGAGCGATATTAATCTA -> TGGAGCGATATTAATCTAA
CTGGCGATTGGATGCCGCA -> TGGCGATTGGATGCCGCAC
CTGGGAACAACTTCCACAC -> TGGGAACAACTTCCACACG
CTGGGCTTACTACGTATAA -> TGGGCTTACTACGTATAAA
CTGGGGCGCGCGCTCTTTG -> TGGGGCGCGCGCTCTTTGA
CTGGGGCGCTCGTCACAGC -> TGGGGCGCTCGTCACAGCT
CTGGGGTACCAGGCTATCG -> TGGGGTACCAGGCTATCGT
CTGGTAAGGTCAAAAGTTT -> TGGTAAGGTCAAAAGTTTC
CTGGTCCCCTACGTGTTTC -> TGGTCCCCTACGTGTTTCG
CTGGTGATATACAGTAACC -> TGGTGATATACAGTAACCC
CTGTATAATGGGTCCGGCG -> TGTATAATGGGTCCGGCGG
CTGTATATTTTAGCCATGG -> TGTATATTTTAGCCATGGG
CTGTCCTGTATAATGGGTC -> TGTCCTGTATAATGGGTCC
CTGTCTAGTTGGTCATCGG -> TGTCTAGTTGGTCATCGGA
CTGTGAAAACCCGCCCGTG -> TGTGAAAACCCGCCCGTGA
CTGTGGCAGAAAGCAGCTC -> TGTGGCAGAAAGCAGCTCA
CTGTGTTCGGCTCCCCTAC -> TGTGTTCGGCTCCCCTACA
CTGTGTTCTGTTATTTGCC -> TGTGTTCTGTTATTTGCCC
CTGTTAGCCTGGGCTTACT -> TGTTAGCCTGGGCTTACTA
CTGTTATTTGCCCCGTAGC -> TGTTATTTGCCCCGTAGCG
CTGTTCGGCATCCCCTTTG -> TGTTCGGCATCCCCTTTGC
CTGTTGGCCTTCTCCATGC -> TGTTGGCCTTCTCCATGCC
CTTAACGAACTGAGTTTTC -> TTAACGAACTGAGTTTTCT
CTTAAGTCCAAAAGCCCTT -> TTAAGTCCAAAAGCCCTTT
CTTACTACGTATAAAATGT -> TTACTACGTATAAAATGTC
CTTAGACCGCGTCAATTGA -> TTAGACCGCGTCAATTGAA
CTTAGCAGGTTATTAATCG -> TTAGCAGGTTATTAATCGG
CTTATCCAAATTCATACGA -> TTATCCAAATTCATACGAA
CTTCAGTACAGCTACTTTG -> TTCAGTACAGCTACTTTGG
CTTCCACACGAAGTATAGC -> TTCCACACGAAGTATAGCC
CTTCCCGTGGTTTCGCGGG -> TTCCCGTGGTTTCGCGGGC
CTTCCGGAGCAGTTTAGAC -> TTCCGGAGCAGTTTAGACA
CTTCCTCGATCGGGGACCA -> TTCCTCGATCGGGGACCAT
CTTCTCCATGCCACACACT -> TTCTCCATGCCACACACTG
CTTCTCCCCCACCCAACTT -> TTCTCCCCCACCCAACTTG
CTTCTGAAAACAGAGCACG -> TTCTGAAAACAGAGCACGC
CTTCTTTCATCCGTCCAAA -> TTCTTTCATCCGTCCAAAT
CTTGCGTCCAAGTGGCAGG -> TTGCGTCCAAGTGGCAGGC
CTTGCTGGGGCGCTCGTCA -> TTGCTGGGGCGCTCGTCAC
CTTGGGGTAGTACATGTTT -> TTGGGGTAGTACATGTTTT
CTTTAGTACTTGCGTCCAA -> TTTAGTACTTGCGTCCAAG
CTTTATACGGACCAGTGGC -> TTTATACGGACCAGTGGCG
CTTTATCTGGGGCGCGCGC -> TTTATCTGGGGCGCGCGCT
CTTTCATCCGTCCAAATGA -> TTTCATCCGTCCAAATGAC
CTTTCGTAACTTAAGTCCA -> TTTCGTAACTTAAGTCCAA
CTTTGAAGTTACAATCCGG -> TTTGAAGTTACAATCCGGG
CTTTGATTCGCCACGTCCT -> TTTGATTCGCCACGTCCTG
CTTTGCGAAGGACTAGGTG -> TTTGCGAAGGACTAGGTGA
CTTTGGAGCAATGTTCCAA -> TTTGGAGCAATGTTCCAAC
GAAAACAGAGCACGCCGAG -> AAAACAGAGCACGCCGAGT
GAAAACCCGCCCGTGACCA -> AAAACCCGCCCGTGACCAA
GAAAAGTTTCTTTATCTGG -> AAAAGTTTCTTTATCTGGG
GAAAGCAGCTCACAGGAGG -> AAAGCAGCTCACAGGAGGC
GAAAGCTTTATACGGACCA -> AAAGCTTTATACGGACCAG
GAAATCAAAACAGCGTTAG -> AAATCAAAACAGCGTTAGG
GAAATCGAGGGGCTGGCGA -> AAATCGAGGGGCTGGCGAT
GAAATCTGGAATGGTACGA -> AAATCTGGAATGGTACGAG
GAAATTCCCTTCCGGAGCA -> AAATTCCCTTCCGGAGCAG
GAACAACTTCCACACGAAG -> AACAACTTCCACACGAAGT
GAACATCTACTCCAGTGGC -> AACATCTACTCCAGTGGCC
GAACATGCTGCCAGACTAA -> AACATGCTGCCAGACTAAC
GAACCAGTCGTCACAGCTC -> AACCAGTCGTCACAGCTCA
GAACCCCTGTGGCAGAAAG -> AACCCCTGTGGCAGAAAGC
GAACGCATCCGGATCGCTT -> AACGCATCCGGATCGCTTT
GAACGTGCCGACTCTACCA -> AACGTGCCGACTCTACCAG
GAACTAGGGGCCTAGGCAA -> AACTAGGGGCCTAGGCAAG
GAACTAGGTCGCTACGCGT -> AACTAGGTCGCTACGCGTC
GAACTGAGTTTTCTACGCT -> AACTGAGTTTTCTACGCTA
GAAGACAAGCAGGCGCTTG -> AAGACAAGCAGGCGCTTGC
GAAGACAGCCATTTGCTTT -> AAGACAGCCATTTGCTTTC
GAAGAGGAGGGACTGAAGG -> AAGAGGAGGGACTGAAGGC
GAAGATCACGGATAGCCCG -> AAGATCACGGATAGCCCGA
GAAGCACAGGAGGATTCGC -> AAGCACAGGAGGATTCGCC
GAAGCCTTCTTTCATCCGT -> AAGCCTTCTTTCATCCGTC
GAAGCTAACAGGACATGCC -> AAGCTAACAGGACATGCCC
GAAGGACTAGGTGAGTGTG -> AAGGACTAGGTGAGTGTGA
GAAGGCTGGAGCGATATTA -> AAGGCTGGAGCGATATTAA
GAAGTAAAATTGGTGCCGC -> AAGTAAAATTGGTGCCGCC
GAAGTATAGCCCGATTTCA -> AAGTATAGCCCGATTTCAA
GAAGTCTTCCTCGATCGGG -> AAGTCTTCCTCGATCGGGG
GAAGTTACAATCCGGGCGT -> AAGTTACAATCCGGGCGTA
GAAGTTACCAGGCTATCGT -> AAGTTACCAGGCTATCGTC
GAAGTTGTTGTTAAGGGTA -> AAGTTGTTGTTAAGGGTAT
GAATACCGAAGTTGTTGTT -> AATACCGAAGTTGTTGTTA
GAATGGTACGAGTGAAGTA -> AATGGTACGAGTGAAGTAA
GACAAGCAGGCGCTTGCTG -> ACAAGCAGGCGCTTGCTGG
GACAATTCTGTTAGCCTGG -> ACAATTCTGTTAGCCTGGG
GACACTACCAAGAAATCGA -> ACACTACCAAGAAATCGAG
GACACTCGTGGAGCATAAG -> ACACTCGTGGAGCATAAGG
GACAGAGTACCAACCCAGG -> ACAGAGTACCAACCCAGGC
GACAGAGTACCCAGAGAGC -> ACAGAGTACCCAGAGAGCT
GACAGAGTAGGTCTGGTGA -> ACAGAGTAGGTCTGGTGAT
GACAGAGTATCTCAGCTGT -> ACAGAGTATCTCAGCTGTC
GACAGCCATTTGCTTTCGT -> ACAGCCATTTGCTTTCGTA
GACAGTAGCAGATGAACAT -> ACAGTAGCAGATGAACATG
GACAGTATGATGTTAACAT -> ACAGTATGATGTTAACATT
GACATCAGGCCACGAGCTG -> ACATCAGGCCACGAGCTGT
GACATGCCCGTACTAGACA -> ACATGCCCGTACTAGACAC
GACATTCTCCTGGACCCCC -> ACATTCTCCTGGACCCCCA
GACCAAGCTGACGGAACGT -> ACCAAGCTGACGGAACGTG
GACCAGACGTAGGGGACAG -> ACCAGACGTAGGGGACAGT
GACCAGTGGCGCATAATAC -> ACCAGTGGCGCATAATACC
GACCATCGAAGCCTTCTTT -> ACCATCGAAGCCTTCTTTC
GACCCCCACACTGAAGACA -> ACCCCCACACTGAAGACAG
GACCCCTTAGACCGCGTCA -> ACCCCTTAGACCGCGTCAA
GACCGCGGAACTAGGTCGC -> ACCGCGGAACTAGGTCGCT
GACCGCGTCAATTGAAAAG -> ACCGCGTCAATTGAAAAGT
GACCTGTGTTCGGCTCCCC -> ACCTGTGTTCGGCTCCCCT
GACGAACTAGGGGCCTAGG -> ACGAACTAGGGGCCTAGGC
GACGCAGACTTAACGAACT -> ACGCAGACTTAACGAACTG
GACGGAACGTGCCGACTCT -> ACGGAACGTGCCGACTCTA
GACGTAGGGGACAGTAGCA -> ACGTAGGGGACAGTAGCAG
GACTAACATAGATACCAGG -> ACTAACATAGATACCAGGC
GACTAGGTGAGTGTGAATA -> ACTAGGTGAGTGTGAATAC
GACTCTACCAGGCTATCGT -> ACTCTACCAGGCTATCGTC
GACTGAAGGCTGGAGCGAT -> ACTGAAGGCTGGAGCGATA
GACTTAACGAACTGAGTTT -> ACTTAACGAACTGAGTTTT
GACTTCTCCCCCACCCAAC -> ACTTCTCCCCCACCCAACT
GAGAAATCAAAACAGCGTT -> AGAAATCAAAACAGCGTTA
GAGAACATCTACTCCAGTG -> AGAACATCTACTCCAGTGG
GAGAGCTAAGTTTAACGCC -> AGAGCTAAGTTTAACGCCA
GAGAGTATCCAATCAGTCG -> AGAGTATCCAATCAGTCGT
GAGATTGAAGAGGAGGGAC -> AGATTGAAGAGGAGGGACT
GAGCAATGTTCCAACACTC -> AGCAATGTTCCAACACTCG
GAGCACGCCGAGTAAGGCC -> AGCACGCCGAGTAAGGCCG
GAGCAGTTTAGACATCAGG -> AGCAGTTTAGACATCAGGC
GAGCATAAGGCACTGGTCC -> AGCATAAGGCACTGGTCCC
GAGCATGGGTTAGATTAGG -> AGCATGGGTTAGATTAGGT
GAGCGATATTAATCTAAGT -> AGCGATATTAATCTAAGTT
GAGCTAAGTTTAACGCCAA -> AGCTAAGTTTAACGCCAAT
GAGCTGTTGGCCTTCTCCA -> AGCTGTTGGCCTTCTCCAT
GAGGAAAGCTTTATACGGA -> AGGAAAGCTTTATACGGAC
GAGGAAGATCACGGATAGC -> AGGAAGATCACGGATAGCC
GAGGAGGGACTGAAGGCTG -> AGGAGGGACTGAAGGCTGG
GAGGATTCGCCCAAGCGTT -> AGGATTCGCCCAAGCGTTG
GAGGCCTCTCGCAACCTCA -> AGGCCTCTCGCAACCTCAA
GAGGCGTCCTCTTCCCGTG -> AGGCGTCCTCTTCCCGTGG
GAGGGACTGAAGGCTGGAG -> AGGGACTGAAGGCTGGAGC
GAGGGCTGCCGAGGCCTCT -> AGGGCTGCCGAGGCCTCTC
GAGGGGCTGGCGATTGGAT -> AGGGGCTGGCGATTGGATG
GAGGGTCGTACCTATGTTC -> AGGGTCGTACCTATGTTCC
GAGGTCTCCTACGCCCTGG -> AGGTCTCCTACGCCCTGGG
GAGTAAGGCCGGGCACTGT -> AGTAAGGCCGGGCACTGTG
GAGTACCAACCCAGGCCCG -> AGTACCAACCCAGGCCCGG
GAGTACCCAGAGAGCTAAG -> AGTACCCAGAGAGCTAAGT
GAGTAGGTCTGGTGATATA -> AGTAGGTCTGGTGATATAC
GAGTATCCAATCAGTCGTT -> AGTATCCAATCAGTCGTTC
GAGTATCTCAGCTGTCTAG -> AGTATCTCAGCTGTCTAGT
GAGTGAAGTAAAATTGGTG -> AGTGAAGTAAAATTGGTGC
GAGTGAGGAAAGCTTTATA -> AGTGAGGAAAGCTTTATAC
GAGTGTGAATACCGAAGTT -> AGTGTGAATACCGAAGTTG
GAGTTTTCTACGCTAAGAG -> AGTTTTCTACGCTAAGAGG
GATAAGGTGAGATTGAAGA -> ATAAGGTGAGATTGAAGAG
GATACCAGGCTATCGTCCA -> ATACCAGGCTATCGTCCAA
GATAGCCCGATGCTCGCGA -> ATAGCCCGATGCTCGCGAG
GATAGGTAGCGGCGTCACG -> ATAGGTAGCGGCGTCACGG
GATAGTCATCCCCGATCTG -> ATAGTCATCCCCGATCTGT
GATATACAGTAACCCCTCG -> ATATACAGTAACCCCTCGG
GATATCGAAGACAAGCAGG -> ATATCGAAGACAAGCAGGC
GATATTAATCTAAGTTGTT -> ATATTAATCTAAGTTGTTT
GATCAAAAGTTACTGATAG -> ATCAAAAGTTACTGATAGT
GATCACGGATAGCCCGATG -> ATCACGGATAGCCCGATGC
GATCCCATTATGTCAACTC -> ATCCCATTATGTCAACTCT
GATCCTAGACAGTATGATG -> ATCCTAGACAGTATGATGT
GATCGACCTGTGTTCGGCT -> ATCGACCTGTGTTCGGCTC
GATCGCTTTAGTACTTGCG -> ATCGCTTTAGTACTTGCGT
GATCGGGGACCATCGAAGC -> ATCGGGGACCATCGAAGCC
GATCTGTCCTGTATAATGG -> ATCTGTCCTGTATAATGGG
GATGAACATGCTGCCAGAC -> ATGAACATGCTGCCAGACT
GATGCCGCACCAAGCAGTA -> ATGCCGCACCAAGCAGTAG
GATGCTCGCGAGCATGGGT -> ATGCTCGCGAGCATGGGTT
GATGTTAACATTAGCGAGA -> ATGTTAACATTAGCGAGAA
GATTAGGTTTTTTGAAATC -> ATTAGGTTTTTTGAAATCT
GATTCGCCACGTCCTGTAT -> ATTCGCCACGTCCTGTATA
GATTCGCCCAAGCGTTGAT -> ATTCGCCCAAGCGTTGATC
GATTGAAGAGGAGGGACTG -> ATTGAAGAGGAGGGACTGA
GATTGGATGCCGCACCAAG -> ATTGGATGCCGCACCAAGC
GATTTCAAACCAGCGCGTC -> ATTTCAAACCAGCGCGTCC
GCAAGACCAGACGTAGGGG -> CAAGACCAGACGTAGGGGA
GCAATGTTCCAACACTCGG -> CAATGTTCCAACACTCGGA
GCACAGGAGGATTCGCCCA -> CACAGGAGGATTCGCCCAA
GCACCAAGCAGTAGAAGTC -> CACCAAGCAGTAGAAGTCT
GCACCCATTCCCCTAACCT -> CACCCATTCCCCTAACCTG
GCACCTGCTGAACGCATCC -> CACCTGCTGAACGCATCCG
GCACGCCGAGTAAGGCCGG -> CACGCCGAGTAAGGCCGGG
GCACTAAAACGGGAGGTCT -> CACTAAAACGGGAGGTCTC
GCACTCGAGGGCTGCCGAG -> CACTCGAGGGCTGCCGAGG
GCACTGGTCCCCTACGTGT -> CACTGGTCCCCTACGTGTT
GCACTGTGAAAACCCGCCC -> CACTGTGAAAACCCGCCCG
GCAGAAAGCAGCTCACAGG -> CAGAAAGCAGCTCACAGGA
GCAGACTTAACGAACTGAG -> CAGACTTAACGAACTGAGT
GCAGATGAACATGCTGCCA -> CAGATGAACATGCTGCCAG
GCAGCTCACAGGAGGCGTC -> CAGCTCACAGGAGGCGTCC
GCAGGCGCTTGCTGGGGCG -> CAGGCGCTTGCTGGGGCGC
GCAGGCGGCCAAGACGCAG -> CAGGCGGCCAAGACGCAGA
GCAGGTTATTAATCGGTGG -> CAGGTTATTAATCGGTGGT
GCAGTAGAAGTCTTCCTCG -> CAGTAGAAGTCTTCCTCGA
GCAGTAGTCAAGGCGAACC -> CAGTAGTCAAGGCGAACCA
GCAGTTTAGACATCAGGCC -> CAGTTTAGACATCAGGCCA
GCATAAGGCACTGGTCCCC -> CATAAGGCACTGGTCCCCT
GCATAATACCATAGCACCT -> CATAATACCATAGCACCTG
GCATACCCCTAACCTGACA -> CATACCCCTAACCTGACAG
GCATAGTAGTCGGATCCCA -> CATAGTAGTCGGATCCCAT
GCATCCCCTTTGCGAAGGA -> CATCCCCTTTGCGAAGGAC
GCATCCGGATCGCTTTAGT -> CATCCGGATCGCTTTAGTA
GCATGGGTTAGATTAGGTT -> CATGGGTTAGATTAGGTTT
GCCAAGACGCAGACTTAAC -> CCAAGACGCAGACTTAACG
GCCAATAATTTTGATATCG -> CCAATAATTTTGATATCGA
GCCACACACTGTTCGGCAT -> CCACACACTGTTCGGCATC
GCCACGAGCTGTTGGCCTT -> CCACGAGCTGTTGGCCTTC
GCCACGTCCTGTATATTTT -> CCACGTCCTGTATATTTTA
GCCAGACTAACATAGATAC -> CCAGACTAACATAGATACC
GCCATGGGTTTCACAACGG -> CCATGGGTTTCACAACGGT
GCCATTTGCTTTCGTAACT -> CCATTTGCTTTCGTAACTT
GCCCAAGCGTTGATCGACC -> CCCAAGCGTTGATCGACCT
GCCCAATATGATCCTAGAC -> CCCAATATGATCCTAGACA
GCCCAATTGAGAGTATCCA -> CCCAATTGAGAGTATCCAA
GCCCACGCCCCCCCTAACC -> CCCACGCCCCCCCTAACCT
GCCCCCCCTAACCTGACAG -> CCCCCCCTAACCTGACAGA
GCCCCGTAGCGGTACACCC -> CCCCGTAGCGGTACACCCT
GCCCGATGCTCGCGAGCAT -> CCCGATGCTCGCGAGCATG
GCCCGATTTCAAACCAGCG -> CCCGATTTCAAACCAGCGC
GCCCGGAAATTCCCTTCCG -> CCCGGAAATTCCCTTCCGG
GCCCGTACTAGACACTACC -> CCCGTACTAGACACTACCA
GCCCGTGACCAAGCTGACG -> CCCGTGACCAAGCTGACGG
GCCCTGGGAACAACTTCCA -> CCCTGGGAACAACTTCCAC
GCCCTTATCCAAATTCATA -> CCCTTATCCAAATTCATAC
GCCCTTTGATTCGCCACGT -> CCCTTTGATTCGCCACGTC
GCCGACTCTACCAGGCTAT -> CCGACTCTACCAGGCTATC
GCCGAGGCCTCTCGCAACC -> CCGAGGCCTCTCGCAACCT
GCCGAGTAAGGCCGGGCAC -> CCGAGTAAGGCCGGGCACT
GCCGCACCAAGCAGTAGAA -> CCGCACCAAGCAGTAGAAG
GCCGCATAGTAGTCGGATC -> CCGCATAGTAGTCGGATCC
GCCGCCCAATTGAGAGTAT -> CCGCCCAATTGAGAGTATC
GCCGGGCACTGTGAAAACC -> CCGGGCACTGTGAAAACCC
GCCTAGGCAAGACCAGACG -> CCTAGGCAAGACCAGACGT
GCCTCAGGTCTTCAGTACA -> CCTCAGGTCTTCAGTACAG
GCCTCCCTAATTTCGCGTT -> CCTCCCTAATTTCGCGTTG
GCCTCTCGCAACCTCAAGA -> CCTCTCGCAACCTCAAGAT
GCCTGGGCTTACTACGTAT -> CCTGGGCTTACTACGTATA
GCCTTAGCAGGTTATTAAT -> CCTTAGCAGGTTATTAATC
GCCTTCTCCATGCCACACA -> CCTTCTCCATGCCACACAC
GCCTTCTTTCATCCGTCCA -> CCTTCTTTCATCCGTCCAA
GCGAACCAGTCGTCACAGC -> CGAACCAGTCGTCACAGCT
GCGAAGGACTAGGTGAGTG -> CGAAGGACTAGGTGAGTGT
GCGACCGCGGAACTAGGTC -> CGACCGCGGAACTAGGTCG
GCGAGAAATCAAAACAGCG -> CGAGAAATCAAAACAGCGT
GCGAGCATGGGTTAGATTA -> CGAGCATGGGTTAGATTAG
GCGAGGAAGATCACGGATA -> CGAGGAAGATCACGGATAG
GCGATATTAATCTAAGTTG -> CGATATTAATCTAAGTTGT
GCGATTGGATGCCGCACCA -> CGATTGGATGCCGCACCAA
GCGCATAATACCATAGCAC -> CGCATAATACCATAGCACC
GCGCGACCGCGGAACTAGG -> CGCGACCGCGGAACTAGGT
GCGCGCGCTCTTTGAAGTT -> CGCGCGCTCTTTGAAGTTA
GCGCGCTCTTTGAAGTTAC -> CGCGCTCTTTGAAGTTACA
GCGCGTCCCGCCTCAGGTC -> CGCGTCCCGCCTCAGGTCT
GCGCTAGAACCCCTGTGGC -> CGCTAGAACCCCTGTGGCA
GCGCTCGTCACAGCTGCAC -> CGCTCGTCACAGCTGCACT
GCGCTCTTTGAAGTTACAA -> CGCTCTTTGAAGTTACAAT
GCGCTTGCTGGGGCGCTCG -> CGCTTGCTGGGGCGCTCGT
GCGGAACTAGGTCGCTACG -> CGGAACTAGGTCGCTACGC
GCGGCCAAGACGCAGACTT -> CGGCCAAGACGCAGACTTA
GCGGCGAGGAAGATCACGG -> CGGCGAGGAAGATCACGGA
GCGGCGTCACGGAAGTTAC -> CGGCGTCACGGAAGTTACC
GCGGGCTAACGCAGTAGTC -> CGGGCTAACGCAGTAGTCA
GCGGTACACCCTGGTAAGG -> CGGTACACCCTGGTAAGGT
GCGTACATCATACAATATT -> CGTACATCATACAATATTA
GCGTCAATGCTAGTCGGCA -> CGTCAATGCTAGTCGGCAC
GCGTCAATTGAAAAGTTTC -> CGTCAATTGAAAAGTTTCT
GCGTCACGGAAGTTACCAG -> CGTCACGGAAGTTACCAGG
GCGTCCAAGTGGCAGGCGG -> CGTCCAAGTGGCAGGCGGC
GCGTCCCGCCTCAGGTCTT -> CGTCCCGCCTCAGGTCTTC
GCGTCCTCTTCCCGTGGTT -> CGTCCTCTTCCCGTGGTTT
GCGTTAGGACGAACTAGGG -> CGTTAGGACGAACTAGGGG
GCGTTGATCGACCTGTGTT -> CGTTGATCGACCTGTGTTC
GCGTTGTCTATGTTAGTTC -> CGTTGTCTATGTTAGTTCC
GCTAACAGGACATGCCCGT -> CTAACAGGACATGCCCGTA
GCTAACGCAGTAGTCAAGG -> CTAACGCAGTAGTCAAGGC
GCTAAGAGGGTCGTACCTA -> CTAAGAGGGTCGTACCTAT
GCTAAGTTTAACGCCAATA -> CTAAGTTTAACGCCAATAA
GCTACGCGTCAATGCTAGT -> CTACGCGTCAATGCTAGTC
GCTACTTTGGAGCAATGTT -> CTACTTTGGAGCAATGTTC
GCTAGAACCCCTGTGGCAG -> CTAGAACCCCTGTGGCAGA
GCTAGTCGGCACTCGAGGG -> CTAGTCGGCACTCGAGGGC
GCTATCGTCCAAAATTTGG -> CTATCGTCCAAAATTTGGC
GCTATCGTCCAACGCCCAC -> CTATCGTCCAACGCCCACG
GCTATCGTCCAAGGGCACC -> CTATCGTCCAAGGGCACCC
GCTATCGTCCAATTCCTAT -> CTATCGTCCAATTCCTATC
GCTCAAAGTTACCCCACGT -> CTCAAAGTTACCCCACGTT
GCTCACAGGAGGCGTCCTC -> CTCACAGGAGGCGTCCTCT
GCTCCCCTACATGGGTCTG -> CTCCCCTACATGGGTCTGT
GCTCGCGAGCATGGGTTAG -> CTCGCGAGCATGGGTTAGA
GCTCGTCACAGCTGCACTA -> CTCGTCACAGCTGCACTAA
GCTCTTTGAAGTTACAATC -> CTCTTTGAAGTTACAATCC
GCTGAACGCATCCGGATCG -> CTGAACGCATCCGGATCGC
GCTGACGGAACGTGCCGAC -> CTGACGGAACGTGCCGACT
GCTGCACTAAAACGGGAGG -> CTGCACTAAAACGGGAGGT
GCTGCCAGACTAACATAGA -> CTGCCAGACTAACATAGAT
GCTGCCGAGGCCTCTCGCA -> CTGCCGAGGCCTCTCGCAA
GCTGGAGCGATATTAATCT -> CTGGAGCGATATTAATCTA
GCTGGCGATTGGATGCCGC -> CTGGCGATTGGATGCCGCA
GCTGGGGCGCTCGTCACAG -> CTGGGGCGCTCGTCACAGC
GCTGGGGTACCAGGCTATC -> CTGGGGTACCAGGCTATCG
GCTGTCTAGTTGGTCATCG -> CTGTCTAGTTGGTCATCGG
GCTGTTGGCCTTCTCCATG -> CTGTTGGCCTTCTCCATGC
GCTTACTACGTATAAAATG -> CTTACTACGTATAAAATGT
GCTTGCTGGGGCGCTCGTC -> CTTGCTGGGGCGCTCGTCA
GCTTTAGTACTTGCGTCCA -> CTTTAGTACTTGCGTCCAA
GCTTTATACGGACCAGTGG -> CTTTATACGGACCAGTGGC
GCTTTCGTAACTTAAGTCC -> CTTTCGTAACTTAAGTCCA
GGAAAGCTTTATACGGACC -> GAAAGCTTTATACGGACCA
GGAAATTCCCTTCCGGAGC -> GAAATTCCCTTCCGGAGCA
GGAACAACTTCCACACGAA -> GAACAACTTCCACACGAAG
GGAACGTGCCGACTCTACC -> GAACGTGCCGACTCTACCA
GGAACTAGGTCGCTACGCG -> GAACTAGGTCGCTACGCGT
GGAAGATCACGGATAGCCC -> GAAGATCACGGATAGCCCG
GGAAGTTACCAGGCTATCG -> GAAGTTACCAGGCTATCGT
GGAATGGTACGAGTGAAGT -> GAATGGTACGAGTGAAGTA
GGACAGTAGCAGATGAACA -> GACAGTAGCAGATGAACAT
GGACATGCCCGTACTAGAC -> GACATGCCCGTACTAGACA
GGACATTCTCCTGGACCCC -> GACATTCTCCTGGACCCCC
GGACCAGTGGCGCATAATA -> GACCAGTGGCGCATAATAC
GGACCATCGAAGCCTTCTT -> GACCATCGAAGCCTTCTTT
GGACCCCCACACTGAAGAC -> GACCCCCACACTGAAGACA
GGACGAACTAGGGGCCTAG -> GACGAACTAGGGGCCTAGG
GGACTAGGTGAGTGTGAAT -> GACTAGGTGAGTGTGAATA
GGACTGAAGGCTGGAGCGA -> GACTGAAGGCTGGAGCGAT
GGACTTCTCCCCCACCCAA -> GACTTCTCCCCCACCCAAC
GGAGCAATGTTCCAACACT -> GAGCAATGTTCCAACACTC
GGAGCAGTTTAGACATCAG -> GAGCAGTTTAGACATCAGG
GGAGCATAAGGCACTGGTC -> GAGCATAAGGCACTGGTCC
GGAGCGATATTAATCTAAG -> GAGCGATATTAATCTAAGT
GGAGGATTCGCCCAAGCGT -> GAGGATTCGCCCAAGCGTT
GGAGGCGTCCTCTTCCCGT -> GAGGCGTCCTCTTCCCGTG
GGAGGGACTGAAGGCTGGA -> GAGGGACTGAAGGCTGGAG
GGAGGTCTCCTACGCCCTG -> GAGGTCTCCTACGCCCTGG
GGATAAGGTGAGATTGAAG -> GATAAGGTGAGATTGAAGA
GGATAGCCCGATGCTCGCG -> GATAGCCCGATGCTCGCGA
GGATAGGTAGCGGCGTCAC -> GATAGGTAGCGGCGTCACG
GGATCCCATTATGTCAACT -> GATCCCATTATGTCAACTC
GGATCGCTTTAGTACTTGC -> GATCGCTTTAGTACTTGCG
GGATGCCGCACCAAGCAGT -> GATGCCGCACCAAGCAGTA
GGATTCGCCCAAGCGTTGA -> GATTCGCCCAAGCGTTGAT
GGCAAGACCAGACGTAGGG -> GCAAGACCAGACGTAGGGG
GGCACCCATTCCCCTAACC -> GCACCCATTCCCCTAACCT
GGCACTCGAGGGCTGCCGA -> GCACTCGAGGGCTGCCGAG
GGCACTGGTCCCCTACGTG -> GCACTGGTCCCCTACGTGT
GGCACTGTGAAAACCCGCC -> GCACTGTGAAAACCCGCCC
GGCAGAAAGCAGCTCACAG -> GCAGAAAGCAGCTCACAGG
GGCAGGCGGCCAAGACGCA -> GCAGGCGGCCAAGACGCAG
GGCATACCCCTAACCTGAC -> GCATACCCCTAACCTGACA
GGCATCCCCTTTGCGAAGG -> GCATCCCCTTTGCGAAGGA
GGCCAAGACGCAGACTTAA -> GCCAAGACGCAGACTTAAC
GGCCACGAGCTGTTGGCCT -> GCCACGAGCTGTTGGCCTT
GGCCCGGAAATTCCCTTCC -> GCCCGGAAATTCCCTTCCG
GGCCGCATAGTAGTCGGAT -> GCCGCATAGTAGTCGGATC
GGCCGGGCACTGTGAAAAC -> GCCGGGCACTGTGAAAACC
GGCCTAGGCAAGACCAGAC -> GCCTAGGCAAGACCAGACG
GGCCTCTCGCAACCTCAAG -> GCCTCTCGCAACCTCAAGA
GGCCTTCTCCATGCCACAC -> GCCTTCTCCATGCCACACA
GGCGAACCAGTCGTCACAG -> GCGAACCAGTCGTCACAGC
GGCGAGGAAGATCACGGAT -> GCGAGGAAGATCACGGATA
GGCGATTGGATGCCGCACC -> GCGATTGGATGCCGCACCA
GGCGCATAATACCATAGCA -> GCGCATAATACCATAGCAC
GGCGCGCGCTCTTTGAAGT -> GCGCGCGCTCTTTGAAGTT
GGCGCTCGTCACAGCTGCA -> GCGCTCGTCACAGCTGCAC
GGCGCTTGCTGGGGCGCTC -> GCGCTTGCTGGGGCGCTCG
GGCGGCCAAGACGCAGACT -> GCGGCCAAGACGCAGACTT
GGCGGCGAGGAAGATCACG -> GCGGCGAGGAAGATCACGG
GGCGTACATCATACAATAT -> GCGTACATCATACAATATT
GGCGTCACGGAAGTTACCA -> GCGTCACGGAAGTTACCAG
GGCGTCCTCTTCCCGTGGT -> GCGTCCTCTTCCCGTGGTT
GGCTAACGCAGTAGTCAAG -> GCTAACGCAGTAGTCAAGG
GGCTATCGTCCAAAATTTG -> GCTATCGTCCAAAATTTGG
GGCTATCGTCCAACGCCCA -> GCTATCGTCCAACGCCCAC
GGCTATCGTCCAAGGGCAC -> GCTATCGTCCAAGGGCACC
GGCTATCGTCCAATTCCTA -> GCTATCGTCCAATTCCTAT
GGCTCCCCTACATGGGTCT -> GCTCCCCTACATGGGTCTG
GGCTGCCGAGGCCTCTCGC -> GCTGCCGAGGCCTCTCGCA
GGCTGGAGCGATATTAATC -> GCTGGAGCGATATTAATCT
GGCTGGCGATTGGATGCCG -> GCTGGCGATTGGATGCCGC
GGCTTACTACGTATAAAAT -> GCTTACTACGTATAAAATG
GGGAACAACTTCCACACGA -> GGAACAACTTCCACACGAA
GGGACAGTAGCAGATGAAC -> GGACAGTAGCAGATGAACA
GGGACCATCGAAGCCTTCT -> GGACCATCGAAGCCTTCTT
GGGACTGAAGGCTGGAGCG -> GGACTGAAGGCTGGAGCGA
GGGAGGTCTCCTACGCCCT -> GGAGGTCTCCTACGCCCTG
GGGCACCCATTCCCCTAAC -> GGCACCCATTCCCCTAACC
GGGCACTGTGAAAACCCGC -> GGCACTGTGAAAACCCGCC
GGGCCTAGGCAAGACCAGA -> GGCCTAGGCAAGACCAGAC
GGGCGCGCGCTCTTTGAAG -> GGCGCGCGCTCTTTGAAGT
GGGCGCTCGTCACAGCTGC -> GGCGCTCGTCACAGCTGCA
GGGCGTACATCATACAATA -> GGCGTACATCATACAATAT
GGGCTAACGCAGTAGTCAA -> GGCTAACGCAGTAGTCAAG
GGGCTGCCGAGGCCTCTCG -> GGCTGCCGAGGCCTCTCGC
GGGCTGGCGATTGGATGCC -> GGCTGGCGATTGGATGCCG
GGGCTTACTACGTATAAAA -> GGCTTACTACGTATAAAAT
GGGGACAGTAGCAGATGAA -> GGGACAGTAGCAGATGAAC
GGGGACCATCGAAGCCTTC -> GGGACCATCGAAGCCTTCT
GGGGCCTAGGCAAGACCAG -> GGGCCTAGGCAAGACCAGA
GGGGCGCGCGCTCTTTGAA -> GGGCGCGCGCTCTTTGAAG
GGGGCGCTCGTCACAGCTG -> GGGCGCTCGTCACAGCTGC
GGGGCTGGCGATTGGATGC -> GGGCTGGCGATTGGATGCC
GGGGTACCAGGCTATCGTC -> GGGTACCAGGCTATCGTCC
GGGGTAGTACATGTTTTTA -> GGGTAGTACATGTTTTTAG
GGGTACCAGGCTATCGTCC -> GGTACCAGGCTATCGTCCA
GGGTAGTACATGTTTTTAG -> GGTAGTACATGTTTTTAGG
GGGTATATTTGAGTGAGGA -> GGTATATTTGAGTGAGGAA
GGGTCCGGCGGCGAGGAAG -> GGTCCGGCGGCGAGGAAGA
GGGTCGTACCTATGTTCCT -> GGTCGTACCTATGTTCCTC
GGGTCTGTGTTCTGTTATT -> GGTCTGTGTTCTGTTATTT
GGGTGGATAAGGTGAGATT -> GGTGGATAAGGTGAGATTG
GGGTTAGATTAGGTTTTTT -> GGTTAGATTAGGTTTTTTG
GGGTTTCACAACGGTTGCC -> GGTTTCACAACGGTTGCCT
GGTAAGGTCAAAAGTTTCT -> GTAAGGTCAAAAGTTTCTA
GGTACACCCTGGTAAGGTC -> GTACACCCTGGTAAGGTCA
GGTACCAGGCTATCGTCCA -> GTACCAGGCTATCGTCCAA
GGTACGAGTGAAGTAAAAT -> GTACGAGTGAAGTAAAATT
GGTAGCGGCGTCACGGAAG -> GTAGCGGCGTCACGGAAGT
GGTAGTACATGTTTTTAGG -> GTAGTACATGTTTTTAGGA
GGTATATTTGAGTGAGGAA -> GTATATTTGAGTGAGGAAA
GGTCAAAAGTTTCTATTCT -> GTCAAAAGTTTCTATTCTG
GGTCATCGGATAGGTAGCG -> GTCATCGGATAGGTAGCGG
GGTCCACGAGAACATCTAC -> GTCCACGAGAACATCTACT
GGTCCAGCGCTAGAACCCC -> GTCCAGCGCTAGAACCCCT
GGTCCCCTACGTGTTTCGG -> GTCCCCTACGTGTTTCGGT
GGTCCGGCGGCGAGGAAGA -> GTCCGGCGGCGAGGAAGAT
GGTCGCTACGCGTCAATGC -> GTCGCTACGCGTCAATGCT
GGTCGTACCTATGTTCCTC -> GTCGTACCTATGTTCCTCG
GGTCTCCTACGCCCTGGGA -> GTCTCCTACGCCCTGGGAA
GGTCTGGTGATATACAGTA -> GTCTGGTGATATACAGTAA
GGTCTGTGTTCTGTTATTT -> GTCTGTGTTCTGTTATTTG
GGTCTTCAGTACAGCTACT -> GTCTTCAGTACAGCTACTT
GGTGAGATTGAAGAGGAGG -> GTGAGATTGAAGAGGAGGG
GGTGAGTGTGAATACCGAA -> GTGAGTGTGAATACCGAAG
GGTGATATACAGTAACCCC -> GTGATATACAGTAACCCCT
GGTGCCGCCCAATTGAGAG -> GTGCCGCCCAATTGAGAGT
GGTGGATAAGGTGAGATTG -> GTGGATAAGGTGAGATTGA
GGTGGTCCACGAGAACATC -> GTGGTCCACGAGAACATCT
GGTGTGCGCGACCGCGGAA -> GTGTGCGCGACCGCGGAAC
GGTTAGATTAGGTTTTTTG -> GTTAGATTAGGTTTTTTGA
GGTTATTAATCGGTGGTCC -> GTTATTAATCGGTGGTCCA
GGTTGCCTTAGCAGGTTAT -> GTTGCCTTAGCAGGTTATT
GGTTTCACAACGGTTGCCT -> GTTTCACAACGGTTGCCTT
GGTTTCGCGGGCTAACGCA -> GTTTCGCGGGCTAACGCAG
GGTTTTTTGAAATCTGGAA -> GTTTTTTGAAATCTGGAAT
GTAAAATTGGTGCCGCCCA -> TAAAATTGGTGCCGCCCAA
GTAACCCCTCGGTCCAGCG -> TAACCCCTCGGTCCAGCGC
GTAACTTAAGTCCAAAAGC -> TAACTTAAGTCCAAAAGCC
GTAAGGCCGGGCACTGTGA -> TAAGGCCGGGCACTGTGAA
GTAAGGTCAAAAGTTTCTA -> TAAGGTCAAAAGTTTCTAT
GTACACCCTGGTAAGGTCA -> TACACCCTGGTAAGGTCAA
GTACAGCTACTTTGGAGCA -> TACAGCTACTTTGGAGCAA
GTACATCATACAATATTAG -> TACATCATACAATATTAGT
GTACATGTTTTTAGGACAT -> TACATGTTTTTAGGACATT
GTACCAACCCAGGCCCGGA -> TACCAACCCAGGCCCGGAA
GTACCAGGCTATCGTCCAA -> TACCAGGCTATCGTCCAAG
GTACCCAGAGAGCTAAGTT -> TACCCAGAGAGCTAAGTTT
GTACCTATGTTCCTCGACA -> TACCTATGTTCCTCGACAA
GTACGAGTGAAGTAAAATT -> TACGAGTGAAGTAAAATTG
GTACTAGACACTACCAAGA -> TACTAGACACTACCAAGAA
GTACTTGCGTCCAAGTGGC -> TACTTGCGTCCAAGTGGCA
GTAGAAGTCTTCCTCGATC -> TAGAAGTCTTCCTCGATCG
GTAGCAGATGAACATGCTG -> TAGCAGATGAACATGCTGC
GTAGCGGCGTCACGGAAGT -> TAGCGGCGTCACGGAAGTT
GTAGCGGTACACCCTGGTA -> TAGCGGTACACCCTGGTAA
GTAGGGGACAGTAGCAGAT -> TAGGGGACAGTAGCAGATG
GTAGGTCTGGTGATATACA -> TAGGTCTGGTGATATACAG
GTAGTACATGTTTTTAGGA -> TAGTACATGTTTTTAGGAC
GTAGTCAAGGCGAACCAGT -> TAGTCAAGGCGAACCAGTC
GTAGTCGGATCCCATTATG -> TAGTCGGATCCCATTATGT
GTATAAAATGTCGCCCAAT -> TATAAAATGTCGCCCAATA
GTATAATGGGTCCGGCGGC -> TATAATGGGTCCGGCGGCG
GTATAGCCCGATTTCAAAC -> TATAGCCCGATTTCAAACC
GTATATTTGAGTGAGGAAA -> TATATTTGAGTGAGGAAAG
GTATATTTTAGCCATGGGT -> TATATTTTAGCCATGGGTT
GTATCCAATCAGTCGTTCA -> TATCCAATCAGTCGTTCAG
GTATCTCAGCTGTCTAGTT -> TATCTCAGCTGTCTAGTTG
GTATGATGTTAACATTAGC -> TATGATGTTAACATTAGCG
GTCAAAAGTTTCTATTCTG -> TCAAAAGTTTCTATTCTGA
GTCAACTCTCTGACACTCG -> TCAACTCTCTGACACTCGT
GTCAAGGCGAACCAGTCGT -> TCAAGGCGAACCAGTCGTC
GTCAATGCTAGTCGGCACT -> TCAATGCTAGTCGGCACTC
GTCAATTGAAAAGTTTCTT -> TCAATTGAAAAGTTTCTTT
GTCACAGCTCAAAGTTACC -> TCACAGCTCAAAGTTACCC
GTCACAGCTGCACTAAAAC -> TCACAGCTGCACTAAAACG
GTCACATTCATACTTCTGA -> TCACATTCATACTTCTGAA
GTCACGGAAGTTACCAGGC -> TCACGGAAGTTACCAGGCT
GTCATCCCCGATCTGTCCT -> TCATCCCCGATCTGTCCTG
GTCATCGGATAGGTAGCGG -> TCATCGGATAGGTAGCGGC
GTCCAAAAGCCCTTTGATT -> TCCAAAAGCCCTTTGATTC
GTCCAAAATTTGGCATACC -> TCCAAAATTTGGCATACCC
GTCCAAATGACCCCTTAGA -> TCCAAATGACCCCTTAGAC
GTCCAACGCCCACGCCCCC -> TCCAACGCCCACGCCCCCC
GTCCAAGGGCACCCATTCC -> TCCAAGGGCACCCATTCCC
GTCCAAGTGGCAGGCGGCC -> TCCAAGTGGCAGGCGGCCA
GTCCAATTCCTATCGTTCC -> TCCAATTCCTATCGTTCCC
GTCCACGAGAACATCTACT -> TCCACGAGAACATCTACTC
GTCCAGCGCTAGAACCCCT -> TCCAGCGCTAGAACCCCTG
GTCCCCTACGTGTTTCGGT -> TCCCCTACGTGTTTCGGTG
GTCCCGCCTCAGGTCTTCA -> TCCCGCCTCAGGTCTTCAG
GTCCGGCGGCGAGGAAGAT -> TCCGGCGGCGAGGAAGATC
GTCCTCTTCCCGTGGTTTC -> TCCTCTTCCCGTGGTTTCG
GTCCTGTATAATGGGTCCG -> TCCTGTATAATGGGTCCGG
GTCCTGTATATTTTAGCCA -> TCCTGTATATTTTAGCCAT
GTCGCCCAATATGATCCTA -> TCGCCCAATATGATCCTAG
GTCGCTACGCGTCAATGCT -> TCGCTACGCGTCAATGCTA
GTCGGATCCCATTATGTCA -> TCGGATCCCATTATGTCAA
GTCGGCACTCGAGGGCTGC -> TCGGCACTCGAGGGCTGCC
GTCGTACCTATGTTCCTCG -> TCGTACCTATGTTCCTCGA
GTCGTCACAGCTCAAAGTT -> TCGTCACAGCTCAAAGTTA
GTCGTTCAGCCCTTATCCA -> TCGTTCAGCCCTTATCCAA
GTCTAGTTGGTCATCGGAT -> TCTAGTTGGTCATCGGATA
GTCTATGTTAGTTCCGGGT -> TCTATGTTAGTTCCGGGTG
GTCTCCTACGCCCTGGGAA -> TCTCCTACGCCCTGGGAAC
GTCTGGTGATATACAGTAA -> TCTGGTGATATACAGTAAC
GTCTGTGTTCTGTTATTTG -> TCTGTGTTCTGTTATTTGC
GTCTTCAGTACAGCTACTT -> TCTTCAGTACAGCTACTTT
GTCTTCCTCGATCGGGGAC -> TCTTCCTCGATCGGGGACC
GTGAAAACCCGCCCGTGAC -> TGAAAACCCGCCCGTGACC
GTGAAGTAAAATTGGTGCC -> TGAAGTAAAATTGGTGCCG
GTGAATACCGAAGTTGTTG -> TGAATACCGAAGTTGTTGT
GTGACCAAGCTGACGGAAC -> TGACCAAGCTGACGGAACG
GTGAGATTGAAGAGGAGGG -> TGAGATTGAAGAGGAGGGA
GTGAGGAAAGCTTTATACG -> TGAGGAAAGCTTTATACGG
GTGAGTGTGAATACCGAAG -> TGAGTGTGAATACCGAAGT
GTGATATACAGTAACCCCT -> TGATATACAGTAACCCCTC
GTGCCGACTCTACCAGGCT -> TGCCGACTCTACCAGGCTA
GTGCCGCCCAATTGAGAGT -> TGCCGCCCAATTGAGAGTA
GTGCGCGACCGCGGAACTA -> TGCGCGACCGCGGAACTAG
GTGGAGCATAAGGCACTGG -> TGGAGCATAAGGCACTGGT
GTGGATAAGGTGAGATTGA -> TGGATAAGGTGAGATTGAA
GTGGCAGAAAGCAGCTCAC -> TGGCAGAAAGCAGCTCACA
GTGGCAGGCGGCCAAGACG -> TGGCAGGCGGCCAAGACGC
GTGGCCGCATAGTAGTCGG -> TGGCCGCATAGTAGTCGGA
GTGGCGCATAATACCATAG -> TGGCGCATAATACCATAGC
GTGGTCCACGAGAACATCT -> TGGTCCACGAGAACATCTA
GTGGTTTCGCGGGCTAACG -> TGGTTTCGCGGGCTAACGC
GTGTGAATACCGAAGTTGT -> TGTGAATACCGAAGTTGTT
GTGTGCGCGACCGCGGAAC -> TGTGCGCGACCGCGGAACT
GTGTTCGGCTCCCCTACAT -> TGTTCGGCTCCCCTACATG
GTGTTCTGTTATTTGCCCC -> TGTTCTGTTATTTGCCCCG
GTGTTTCGGTGTGCGCGAC -> TGTTTCGGTGTGCGCGACC
GTTAACATTAGCGAGAAAT -> TTAACATTAGCGAGAAATC
GTTAAGGGTATATTTGAGT -> TTAAGGGTATATTTGAGTG
GTTACAATCCGGGCGTACA -> TTACAATCCGGGCGTACAT
GTTACCAGGCTATCGTCCA -> TTACCAGGCTATCGTCCAA
GTTACCCCACGTTTATGCC -> TTACCCCACGTTTATGCCT
GTTACTGATAGTCATCCCC -> TTACTGATAGTCATCCCCG
GTTAGATTAGGTTTTTTGA -> TTAGATTAGGTTTTTTGAA
GTTAGCCTGGGCTTACTAC -> TTAGCCTGGGCTTACTACG
GTTAGGACGAACTAGGGGC -> TTAGGACGAACTAGGGGCC
GTTAGTTCCGGGTGGATAA -> TTAGTTCCGGGTGGATAAG
GTTATTAATCGGTGGTCCA -> TTATTAATCGGTGGTCCAC
GTTATTTGCCCCGTAGCGG -> TTATTTGCCCCGTAGCGGT
GTTCAGCCCTTATCCAAAT -> TTCAGCCCTTATCCAAATT
GTTCCAACACTCGGACTTC -> TTCCAACACTCGGACTTCT
GTTCCCCTAACCTGACAGA -> TTCCCCTAACCTGACAGAG
GTTCCGGGTGGATAAGGTG -> TTCCGGGTGGATAAGGTGA
GTTCCTCGACAATTCTGTT -> TTCCTCGACAATTCTGTTA
GTTCGGCATCCCCTTTGCG -> TTCGGCATCCCCTTTGCGA
GTTCGGCTCCCCTACATGG -> TTCGGCTCCCCTACATGGG
GTTCTGTTATTTGCCCCGT -> TTCTGTTATTTGCCCCGTA
GTTGATCGACCTGTGTTCG -> TTGATCGACCTGTGTTCGG
GTTGCCTTAGCAGGTTATT -> TTGCCTTAGCAGGTTATTA
GTTGGCCTTCTCCATGCCA -> TTGGCCTTCTCCATGCCAC
GTTGGTCATCGGATAGGTA -> TTGGTCATCGGATAGGTAG
GTTGTCTATGTTAGTTCCG -> TTGTCTATGTTAGTTCCGG
GTTGTTAAGGGTATATTTG -> TTGTTAAGGGTATATTTGA
GTTGTTGTTAAGGGTATAT -> TTGTTGTTAAGGGTATATT
GTTGTTTTTCGATCAAAAG -> TTGTTTTTCGATCAAAAGT
GTTTAACGCCAATAATTTT -> TTTAACGCCAATAATTTTG
GTTTAGACATCAGGCCACG -> TTTAGACATCAGGCCACGA
GTTTATGCCTCCCTAATTT -> TTTATGCCTCCCTAATTTC
GTTTCACAACGGTTGCCTT -> TTTCACAACGGTTGCCTTA
GTTTCGCGGGCTAACGCAG -> TTTCGCGGGCTAACGCAGT
GTTTCGGTGTGCGCGACCG -> TTTCGGTGTGCGCGACCGC
GTTTCTATTCTGAAGCTAA -> TTTCTATTCTGAAGCTAAC
GTTTCTTTATCTGGGGCGC -> TTTCTTTATCTGGGGCGCG
GTTTTCTACGCTAAGAGGG -> TTTTCTACGCTAAGAGGGT
GTTTTTAGGACATTCTCCT -> TTTTTAGGACATTCTCCTG
GTTTTTCGATCAAAAGTTA -> TTTTTCGATCAAAAGTTAC
GTTTTTTGAAATCTGGAAT -> TTTTTTGAAATCTGGAATG
TAAAACGGGAGGTCTCCTA -> AAAACGGGAGGTCTCCTAC
TAAAATGTCGCCCAATATG -> AAAATGTCGCCCAATATGA
TAAAATTGGTGCCGCCCAA -> AAAATTGGTGCCGCCCAAT
TAACAGGACATGCCCGTAC -> AACAGGACATGCCCGTACT
TAACATAGATACCAGGCTA -> AACATAGATACCAGGCTAT
TAACATTAGCGAGAAATCA -> AACATTAGCGAGAAATCAA
TAACCCCTCGGTCCAGCGC -> AACCCCTCGGTCCAGCGCT
TAACCTGACAGAGTACCAA -> AACCTGACAGAGTACCAAC
TAACCTGACAGAGTACCCA -> AACCTGACAGAGTACCCAG
TAACCTGACAGAGTAGGTC -> AACCTGACAGAGTAGGTCT
TAACCTGACAGAGTATCTC -> AACCTGACAGAGTATCTCA
TAACGAACTGAGTTTTCTA -> AACGAACTGAGTTTTCTAC
TAACGCAGTAGTCAAGGCG -> AACGCAGTAGTCAAGGCGA
TAACGCCAATAATTTTGAT -> AACGCCAATAATTTTGATA
TAACTTAAGTCCAAAAGCC -> AACTTAAGTCCAAAAGCCC
TAAGAGGGTCGTACCTATG -> AAGAGGGTCGTACCTATGT
TAAGGCACTGGTCCCCTAC -> AAGGCACTGGTCCCCTACG
TAAGGCCGGGCACTGTGAA -> AAGGCCGGGCACTGTGAAA
TAAGGGTATATTTGAGTGA -> AAGGGTATATTTGAGTGAG
TAAGGTCAAAAGTTTCTAT -> AAGGTCAAAAGTTTCTATT
TAAGGTGAGATTGAAGAGG -> AAGGTGAGATTGAAGAGGA
TAAGTCCAAAAGCCCTTTG -> AAGTCCAAAAGCCCTTTGA
TAAGTTGTTTTTCGATCAA -> AAGTTGTTTTTCGATCAAA
TAAGTTTAACGCCAATAAT -> AAGTTTAACGCCAATAATT
TAATACCATAGCACCTGCT -> AATACCATAGCACCTGCTG
TAATCGGTGGTCCACGAGA -> AATCGGTGGTCCACGAGAA
TAATCTAAGTTGTTTTTCG -> AATCTAAGTTGTTTTTCGA
TAATGGGTCCGGCGGCGAG -> AATGGGTCCGGCGGCGAGG
TAATTTCGCGTTGTCTATG -> AATTTCGCGTTGTCTATGT
TAATTTTGATATCGAAGAC -> AATTTTGATATCGAAGACA
TACAATATTAGTCACATTC -> ACAATATTAGTCACATTCA
TACAATCCGGGCGTACATC -> ACAATCCGGGCGTACATCA
TACACCCTGGTAAGGTCAA -> ACACCCTGGTAAGGTCAAA
TACAGCTACTTTGGAGCAA -> ACAGCTACTTTGGAGCAAT
TACAGTAACCCCTCGGTCC -> ACAGTAACCCCTCGGTCCA
TACATCATACAATATTAGT -> ACATCATACAATATTAGTC
TACATGGGTCTGTGTTCTG -> ACATGGGTCTGTGTTCTGT
TACATGTTTTTAGGACATT -> ACATGTTTTTAGGACATTC
TACCAACCCAGGCCCGGAA -> ACCAACCCAGGCCCGGAAA
TACCAAGAAATCGAGGGGC -> ACCAAGAAATCGAGGGGCT
TACCAGGCTATCGTCCAAA -> ACCAGGCTATCGTCCAAAA
TACCAGGCTATCGTCCAAC -> ACCAGGCTATCGTCCAACG
TACCAGGCTATCGTCCAAG -> ACCAGGCTATCGTCCAAGG
TACCAGGCTATCGTCCAAT -> ACCAGGCTATCGTCCAATT
TACCATAGCACCTGCTGAA -> ACCATAGCACCTGCTGAAC
TACCCAGAGAGCTAAGTTT -> ACCCAGAGAGCTAAGTTTA
TACCCCACGTTTATGCCTC -> ACCCCACGTTTATGCCTCC
TACCCCTAACCTGACAGAG -> ACCCCTAACCTGACAGAGT
TACCGAAGTTGTTGTTAAG -> ACCGAAGTTGTTGTTAAGG
TACCTATGTTCCTCGACAA -> ACCTATGTTCCTCGACAAT
TACGAAGCACAGGAGGATT -> ACGAAGCACAGGAGGATTC
TACGAGTGAAGTAAAATTG -> ACGAGTGAAGTAAAATTGG
TACGCCCTGGGAACAACTT -> ACGCCCTGGGAACAACTTC
TACGCGTCAATGCTAGTCG -> ACGCGTCAATGCTAGTCGG
TACGCTAAGAGGGTCGTAC -> ACGCTAAGAGGGTCGTACC
TACGCTGGGGTACCAGGCT -> ACGCTGGGGTACCAGGCTA
TACGGACCAGTGGCGCATA -> ACGGACCAGTGGCGCATAA
TACGTATAAAATGTCGCCC -> ACGTATAAAATGTCGCCCA
TACGTGTTTCGGTGTGCGC -> ACGTGTTTCGGTGTGCGCG
TACTACGTATAAAATGTCG -> ACTACGTATAAAATGTCGC
TACTAGACACTACCAAGAA -> ACTAGACACTACCAAGAAA
TACTCCAGTGGCCGCATAG -> ACTCCAGTGGCCGCATAGT
TACTGATAGTCATCCCCGA -> ACTGATAGTCATCCCCGAT
TACTTCTGAAAACAGAGCA -> ACTTCTGAAAACAGAGCAC
TACTTGCGTCCAAGTGGCA -> ACTTGCGTCCAAGTGGCAG
TACTTTGGAGCAATGTTCC -> ACTTTGGAGCAATGTTCCA
TAGAACCCCTGTGGCAGAA -> AGAACCCCTGTGGCAGAAA
TAGAAGTCTTCCTCGATCG -> AGAAGTCTTCCTCGATCGG
TAGACACTACCAAGAAATC -> AGACACTACCAAGAAATCG
TAGACAGTATGATGTTAAC -> AGACAGTATGATGTTAACA
TAGACATCAGGCCACGAGC -> AGACATCAGGCCACGAGCT
TAGACCGCGTCAATTGAAA -> AGACCGCGTCAATTGAAAA
TAGATACCAGGCTATCGTC -> AGATACCAGGCTATCGTCC
TAGATTAGGTTTTTTGAAA -> AGATTAGGTTTTTTGAAAT
TAGCACCTGCTGAACGCAT -> AGCACCTGCTGAACGCATC
TAGCAGATGAACATGCTGC -> AGCAGATGAACATGCTGCC
TAGCAGGTTATTAATCGGT -> AGCAGGTTATTAATCGGTG
TAGCCATGGGTTTCACAAC -> AGCCATGGGTTTCACAACG
TAGCCCGATGCTCGCGAGC -> AGCCCGATGCTCGCGAGCA
TAGCCCGATTTCAAACCAG -> AGCCCGATTTCAAACCAGC
TAGCCTGGGCTTACTACGT -> AGCCTGGGCTTACTACGTA
TAGCGAGAAATCAAAACAG -> AGCGAGAAATCAAAACAGC
TAGCGGCGTCACGGAAGTT -> AGCGGCGTCACGGAAGTTA
TAGCGGTACACCCTGGTAA -> AGCGGTACACCCTGGTAAG
TAGGACATTCTCCTGGACC -> AGGACATTCTCCTGGACCC
TAGGACGAACTAGGGGCCT -> AGGACGAACTAGGGGCCTA
TAGGCAAGACCAGACGTAG -> AGGCAAGACCAGACGTAGG
TAGGGGACAGTAGCAGATG -> AGGGGACAGTAGCAGATGA
TAGGGGCCTAGGCAAGACC -> AGGGGCCTAGGCAAGACCA
TAGGTAGCGGCGTCACGGA -> AGGTAGCGGCGTCACGGAA
TAGGTCGCTACGCGTCAAT -> AGGTCGCTACGCGTCAATG
TAGGTCTGGTGATATACAG -> AGGTCTGGTGATATACAGT
TAGGTGAGTGTGAATACCG -> AGGTGAGTGTGAATACCGA
TAGGTTTTTTGAAATCTGG -> AGGTTTTTTGAAATCTGGA
TAGTACATGTTTTTAGGAC -> AGTACATGTTTTTAGGACA
TAGTACTTGCGTCCAAGTG -> AGTACTTGCGTCCAAGTGG
TAGTAGTCGGATCCCATTA -> AGTAGTCGGATCCCATTAT
TAGTCAAGGCGAACCAGTC -> AGTCAAGGCGAACCAGTCG
TAGTCACATTCATACTTCT -> AGTCACATTCATACTTCTG
TAGTCATCCCCGATCTGTC -> AGTCATCCCCGATCTGTCC
TAGTCGGATCCCATTATGT -> AGTCGGATCCCATTATGTC
TAGTCGGCACTCGAGGGCT -> AGTCGGCACTCGAGGGCTG
TAGTTCCGGGTGGATAAGG -> AGTTCCGGGTGGATAAGGT
TAGTTGGTCATCGGATAGG -> AGTTGGTCATCGGATAGGT
TATAAAATGTCGCCCAATA -> ATAAAATGTCGCCCAATAT
TATAATGGGTCCGGCGGCG -> ATAATGGGTCCGGCGGCGA
TATACAGTAACCCCTCGGT -> ATACAGTAACCCCTCGGTC
TATACGGACCAGTGGCGCA -> ATACGGACCAGTGGCGCAT
TATAGCCCGATTTCAAACC -> ATAGCCCGATTTCAAACCA
TATATTTGAGTGAGGAAAG -> ATATTTGAGTGAGGAAAGC
TATATTTTAGCCATGGGTT -> ATATTTTAGCCATGGGTTT
TATCCAAATTCATACGAAG -> ATCCAAATTCATACGAAGC
TATCCAATCAGTCGTTCAG -> ATCCAATCAGTCGTTCAGC
TATCGAAGACAAGCAGGCG -> ATCGAAGACAAGCAGGCGC
TATCGTCCAAAATTTGGCA -> ATCGTCCAAAATTTGGCAT
TATCGTCCAACGCCCACGC -> ATCGTCCAACGCCCACGCC
TATCGTCCAAGGGCACCCA -> ATCGTCCAAGGGCACCCAT
TATCGTCCAATTCCTATCG -> ATCGTCCAATTCCTATCGT
TATCGTTCCCCTAACCTGA -> ATCGTTCCCCTAACCTGAC
TATCTCAGCTGTCTAGTTG -> ATCTCAGCTGTCTAGTTGG
TATCTGGGGCGCGCGCTCT -> ATCTGGGGCGCGCGCTCTT
TATGATCCTAGACAGTATG -> ATGATCCTAGACAGTATGA
TATGATGTTAACATTAGCG -> ATGATGTTAACATTAGCGA
TATGCCTCCCTAATTTCGC -> ATGCCTCCCTAATTTCGCG
TATGTCAACTCTCTGACAC -> ATGTCAACTCTCTGACACT
TATGTTAGTTCCGGGTGGA -> ATGTTAGTTCCGGGTGGAT
TATGTTCCTCGACAATTCT -> ATGTTCCTCGACAATTCTG
TATTAATCGGTGGTCCACG -> ATTAATCGGTGGTCCACGA
TATTAATCTAAGTTGTTTT -> ATTAATCTAAGTTGTTTTT
TATTAGTCACATTCATACT -> ATTAGTCACATTCATACTT
TATTCTGAAGCTAACAGGA -> ATTCTGAAGCTAACAGGAC
TATTTGAGTGAGGAAAGCT -> ATTTGAGTGAGGAAAGCTT
TATTTGCCCCGTAGCGGTA -> ATTTGCCCCGTAGCGGTAC
TATTTTAGCCATGGGTTTC -> ATTTTAGCCATGGGTTTCA
TCAAAACAGCGTTAGGACG -> CAAAACAGCGTTAGGACGA
TCAAAAGTTACTGATAGTC -> CAAAAGTTACTGATAGTCA
TCAAAAGTTTCTATTCTGA -> CAAAAGTTTCTATTCTGAA
TCAAACCAGCGCGTCCCGC -> CAAACCAGCGCGTCCCGCC
TCAAAGTTACCCCACGTTT -> CAAAGTTACCCCACGTTTA
TCAACTCTCTGACACTCGT -> CAACTCTCTGACACTCGTG
TCAAGGCGAACCAGTCGTC -> CAAGGCGAACCAGTCGTCA
TCAATGCTAGTCGGCACTC -> CAATGCTAGTCGGCACTCG
TCAATTGAAAAGTTTCTTT -> CAATTGAAAAGTTTCTTTA
TCACAACGGTTGCCTTAGC -> CACAACGGTTGCCTTAGCA
TCACAGCTCAAAGTTACCC -> CACAGCTCAAAGTTACCCC
TCACAGCTGCACTAAAACG -> CACAGCTGCACTAAAACGG
TCACAGGAGGCGTCCTCTT -> CACAGGAGGCGTCCTCTTC
TCACATTCATACTTCTGAA -> CACATTCATACTTCTGAAA
TCACGGAAGTTACCAGGCT -> CACGGAAGTTACCAGGCTA
TCACGGATAGCCCGATGCT -> CACGGATAGCCCGATGCTC
TCAGCCCTTATCCAAATTC -> CAGCCCTTATCCAAATTCA
TCAGCTGTCTAGTTGGTCA -> CAGCTGTCTAGTTGGTCAT
TCAGGCCACGAGCTGTTGG -> CAGGCCACGAGCTGTTGGC
TCAGGTCTTCAGTACAGCT -> CAGGTCTTCAGTACAGCTA
TCAGTACAGCTACTTTGGA -> CAGTACAGCTACTTTGGAG
TCAGTCGTTCAGCCCTTAT -> CAGTCGTTCAGCCCTTATC
TCATACAATATTAGTCACA -> CATACAATATTAGTCACAT
TCATACGAAGCACAGGAGG -> CATACGAAGCACAGGAGGA
TCATACTTCTGAAAACAGA -> CATACTTCTGAAAACAGAG
TCATCCCCGATCTGTCCTG -> CATCCCCGATCTGTCCTGT
TCATCCGTCCAAATGACCC -> CATCCGTCCAAATGACCCC
TCATCGGATAGGTAGCGGC -> CATCGGATAGGTAGCGGCG
TCCAAAAGCCCTTTGATTC -> CCAAAAGCCCTTTGATTCG
TCCAAAATTTGGCATACCC -> CCAAAATTTGGCATACCCC
TCCAAATGACCCCTTAGAC -> CCAAATGACCCCTTAGACC
TCCAAATTCATACGAAGCA -> CCAAATTCATACGAAGCAC
TCCAACACTCGGACTTCTC -> CCAACACTCGGACTTCTCC
TCCAACGCCCACGCCCCCC -> CCAACGCCCACGCCCCCCC
TCCAAGGGCACCCATTCCC -> CCAAGGGCACCCATTCCCC
TCCAAGTGGCAGGCGGCCA -> CCAAGTGGCAGGCGGCCAA
TCCAATCAGTCGTTCAGCC -> CCAATCAGTCGTTCAGCCC
TCCAATTCCTATCGTTCCC -> CCAATTCCTATCGTTCCCC
TCCACACGAAGTATAGCCC -> CCACACGAAGTATAGCCCG
TCCACGAGAACATCTACTC -> CCACGAGAACATCTACTCC
TCCAGCGCTAGAACCCCTG -> CCAGCGCTAGAACCCCTGT
TCCAGTGGCCGCATAGTAG -> CCAGTGGCCGCATAGTAGT
TCCATGCCACACACTGTTC -> CCATGCCACACACTGTTCG
TCCCATTATGTCAACTCTC -> CCCATTATGTCAACTCTCT
TCCCCCACCCAACTTGGGG -> CCCCCACCCAACTTGGGGT
TCCCCGATCTGTCCTGTAT -> CCCCGATCTGTCCTGTATA
TCCCCTAACCTGACAGAGT -> CCCCTAACCTGACAGAGTA,CCCCTAACCTGACAGAGTA
TCCCCTACATGGGTCTGTG -> CCCCTACATGGGTCTGTGT
TCCCCTACGTGTTTCGGTG -> CCCCTACGTGTTTCGGTGT
TCCCCTTTGCGAAGGACTA -> CCCCTTTGCGAAGGACTAG
TCCCGCCTCAGGTCTTCAG -> CCCGCCTCAGGTCTTCAGT
TCCCGTGGTTTCGCGGGCT -> CCCGTGGTTTCGCGGGCTA
TCCCTAATTTCGCGTTGTC -> CCCTAATTTCGCGTTGTCT
TCCCTTCCGGAGCAGTTTA -> CCCTTCCGGAGCAGTTTAG
TCCGGAGCAGTTTAGACAT -> CCGGAGCAGTTTAGACATC
TCCGGATCGCTTTAGTACT -> CCGGATCGCTTTAGTACTT
TCCGGCGGCGAGGAAGATC -> CCGGCGGCGAGGAAGATCA
TCCGGGCGTACATCATACA -> CCGGGCGTACATCATACAA
TCCGGGTGGATAAGGTGAG -> CCGGGTGGATAAGGTGAGA
TCCGTCCAAATGACCCCTT -> CCGTCCAAATGACCCCTTA
TCCTACGCCCTGGGAACAA -> CCTACGCCCTGGGAACAAC
TCCTAGACAGTATGATGTT -> CCTAGACAGTATGATGTTA
TCCTATCGTTCCCCTAACC -> CCTATCGTTCCCCTAACCT
TCCTCGACAATTCTGTTAG -> CCTCGACAATTCTGTTAGC
TCCTCGATCGGGGACCATC -> CCTCGATCGGGGACCATCG
TCCTCTTCCCGTGGTTTCG -> CCTCTTCCCGTGGTTTCGC
TCCTGGACCCCCACACTGA -> CCTGGACCCCCACACTGAA
TCCTGTATAATGGGTCCGG -> CCTGTATAATGGGTCCGGC
TCCTGTATATTTTAGCCAT -> CCTGTATATTTTAGCCATG
TCGAAGACAAGCAGGCGCT -> CGAAGACAAGCAGGCGCTT
TCGAAGCCTTCTTTCATCC -> CGAAGCCTTCTTTCATCCG
TCGACAATTCTGTTAGCCT -> CGACAATTCTGTTAGCCTG
TCGACCTGTGTTCGGCTCC -> CGACCTGTGTTCGGCTCCC
TCGAGGGCTGCCGAGGCCT -> CGAGGGCTGCCGAGGCCTC
TCGAGGGGCTGGCGATTGG -> CGAGGGGCTGGCGATTGGA
TCGATCAAAAGTTACTGAT -> CGATCAAAAGTTACTGATA
TCGATCGGGGACCATCGAA -> CGATCGGGGACCATCGAAG
TCGCCACGTCCTGTATATT -> CGCCACGTCCTGTATATTT
TCGCCCAAGCGTTGATCGA -> CGCCCAAGCGTTGATCGAC
TCGCCCAATATGATCCTAG -> CGCCCAATATGATCCTAGA
TCGCGAGCATGGGTTAGAT -> CGCGAGCATGGGTTAGATT
TCGCGGGCTAACGCAGTAG -> CGCGGGCTAACGCAGTAGT
TCGCGTTGTCTATGTTAGT -> CGCGTTGTCTATGTTAGTT
TCGCTACGCGTCAATGCTA -> CGCTACGCGTCAATGCTAG
TCGCTTTAGTACTTGCGTC -> CGCTTTAGTACTTGCGTCC
TCGGACTTCTCCCCCACCC -> CGGACTTCTCCCCCACCCA
TCGGATAGGTAGCGGCGTC -> CGGATAGGTAGCGGCGTCA
TCGGATCCCATTATGTCAA -> CGGATCCCATTATGTCAAC
TCGGCACTCGAGGGCTGCC -> CGGCACTCGAGGGCTGCCG
TCGGCATCCCCTTTGCGAA -> CGGCATCCCCTTTGCGAAG
TCGGCTCCCCTACATGGGT -> CGGCTCCCCTACATGGGTC
TCGGGGACCATCGAAGCCT -> CGGGGACCATCGAAGCCTT
TCGGTCCAGCGCTAGAACC -> CGGTCCAGCGCTAGAACCC
TCGGTGGTCCACGAGAACA -> CGGTGGTCCACGAGAACAT
TCGGTGTGCGCGACCGCGG -> CGGTGTGCGCGACCGCGGA
TCGTAACTTAAGTCCAAAA -> CGTAACTTAAGTCCAAAAG
TCGTACCTATGTTCCTCGA -> CGTACCTATGTTCCTCGAC
TCGTCACAGCTCAAAGTTA -> CGTCACAGCTCAAAGTTAC
TCGTCACAGCTGCACTAAA -> CGTCACAGCTGCACTAAAA
TCGTCCAAAATTTGGCATA -> CGTCCAAAATTTGGCATAC
TCGTCCAACGCCCACGCCC -> CGTCCAACGCCCACGCCCC
TCGTCCAAGGGCACCCATT -> CGTCCAAGGGCACCCATTC
TCGTCCAATTCCTATCGTT -> CGTCCAATTCCTATCGTTC
TCGTGGAGCATAAGGCACT -> CGTGGAGCATAAGGCACTG
TCGTTCAGCCCTTATCCAA -> CGTTCAGCCCTTATCCAAA
TCGTTCCCCTAACCTGACA -> CGTTCCCCTAACCTGACAG
TCTAAGTTGTTTTTCGATC -> CTAAGTTGTTTTTCGATCA
TCTACCAGGCTATCGTCCA -> CTACCAGGCTATCGTCCAA
TCTACGCTAAGAGGGTCGT -> CTACGCTAAGAGGGTCGTA
TCTACTCCAGTGGCCGCAT -> CTACTCCAGTGGCCGCATA
TCTAGTTGGTCATCGGATA -> CTAGTTGGTCATCGGATAG
TCTATGTTAGTTCCGGGTG -> CTATGTTAGTTCCGGGTGG
TCTATTCTGAAGCTAACAG -> CTATTCTGAAGCTAACAGG
TCTCAGCTGTCTAGTTGGT -> CTCAGCTGTCTAGTTGGTC
TCTCCATGCCACACACTGT -> CTCCATGCCACACACTGTT
TCTCCCCCACCCAACTTGG -> CTCCCCCACCCAACTTGGG
TCTCCTACGCCCTGGGAAC -> CTCCTACGCCCTGGGAACA
TCTCCTGGACCCCCACACT -> CTCCTGGACCCCCACACTG
TCTCGCAACCTCAAGATGG -> CTCGCAACCTCAAGATGGT
TCTCTGACACTCGTGGAGC -> CTCTGACACTCGTGGAGCA
TCTGAAAACAGAGCACGCC -> CTGAAAACAGAGCACGCCG
TCTGAAGCTAACAGGACAT -> CTGAAGCTAACAGGACATG
TCTGACACTCGTGGAGCAT -> CTGACACTCGTGGAGCATA
TCTGGAATGGTACGAGTGA -> CTGGAATGGTACGAGTGAA
TCTGGGGCGCGCGCTCTTT -> CTGGGGCGCGCGCTCTTTG
TCTGGTGATATACAGTAAC -> CTGGTGATATACAGTAACC
TCTGTCCTGTATAATGGGT -> CTGTCCTGTATAATGGGTC
TCTGTGTTCTGTTATTTGC -> CTGTGTTCTGTTATTTGCC
TCTGTTAGCCTGGGCTTAC -> CTGTTAGCCTGGGCTTACT
TCTGTTATTTGCCCCGTAG -> CTGTTATTTGCCCCGTAGC
TCTTCAGTACAGCTACTTT -> CTTCAGTACAGCTACTTTG
TCTTCCCGTGGTTTCGCGG -> CTTCCCGTGGTTTCGCGGG
TCTTCCTCGATCGGGGACC -> CTTCCTCGATCGGGGACCA
TCTTTATCTGGGGCGCGCG -> CTTTATCTGGGGCGCGCGC
TCTTTCATCCGTCCAAATG -> CTTTCATCCGTCCAAATGA
TCTTTGAAGTTACAATCCG -> CTTTGAAGTTACAATCCGG
TGAAAACAGAGCACGCCGA -> GAAAACAGAGCACGCCGAG
TGAAAACCCGCCCGTGACC -> GAAAACCCGCCCGTGACCA
TGAAAAGTTTCTTTATCTG -> GAAAAGTTTCTTTATCTGG
TGAAATCTGGAATGGTACG -> GAAATCTGGAATGGTACGA
TGAACATGCTGCCAGACTA -> GAACATGCTGCCAGACTAA
TGAACGCATCCGGATCGCT -> GAACGCATCCGGATCGCTT
TGAAGACAGCCATTTGCTT -> GAAGACAGCCATTTGCTTT
TGAAGAGGAGGGACTGAAG -> GAAGAGGAGGGACTGAAGG
TGAAGCTAACAGGACATGC -> GAAGCTAACAGGACATGCC
TGAAGGCTGGAGCGATATT -> GAAGGCTGGAGCGATATTA
TGAAGTAAAATTGGTGCCG -> GAAGTAAAATTGGTGCCGC
TGAAGTTACAATCCGGGCG -> GAAGTTACAATCCGGGCGT
TGAATACCGAAGTTGTTGT -> GAATACCGAAGTTGTTGTT
TGACACTCGTGGAGCATAA -> GACACTCGTGGAGCATAAG
TGACAGAGTACCAACCCAG -> GACAGAGTACCAACCCAGG
TGACAGAGTACCCAGAGAG -> GACAGAGTACCCAGAGAGC
TGACAGAGTAGGTCTGGTG -> GACAGAGTAGGTCTGGTGA
TGACAGAGTATCTCAGCTG -> GACAGAGTATCTCAGCTGT
TGACCAAGCTGACGGAACG -> GACCAAGCTGACGGAACGT
TGACCCCTTAGACCGCGTC -> GACCCCTTAGACCGCGTCA
TGACGGAACGTGCCGACTC -> GACGGAACGTGCCGACTCT
TGAGAGTATCCAATCAGTC -> GAGAGTATCCAATCAGTCG
TGAGATTGAAGAGGAGGGA -> GAGATTGAAGAGGAGGGAC
TGAGGAAAGCTTTATACGG -> GAGGAAAGCTTTATACGGA
TGAGTGAGGAAAGCTTTAT -> GAGTGAGGAAAGCTTTATA
TGAGTGTGAATACCGAAGT -> GAGTGTGAATACCGAAGTT
TGAGTTTTCTACGCTAAGA -> GAGTTTTCTACGCTAAGAG
TGATAGTCATCCCCGATCT -> GATAGTCATCCCCGATCTG
TGATATACAGTAACCCCTC -> GATATACAGTAACCCCTCG
TGATATCGAAGACAAGCAG -> GATATCGAAGACAAGCAGG
TGATCCTAGACAGTATGAT -> GATCCTAGACAGTATGATG
TGATCGACCTGTGTTCGGC -> GATCGACCTGTGTTCGGCT
TGATGTTAACATTAGCGAG -> GATGTTAACATTAGCGAGA
TGATTCGCCACGTCCTGTA -> GATTCGCCACGTCCTGTAT
TGCACTAAAACGGGAGGTC -> GCACTAAAACGGGAGGTCT
TGCCACACACTGTTCGGCA -> GCCACACACTGTTCGGCAT
TGCCAGACTAACATAGATA -> GCCAGACTAACATAGATAC
TGCCCCGTAGCGGTACACC -> GCCCCGTAGCGGTACACCC
TGCCCGTACTAGACACTAC -> GCCCGTACTAGACACTACC
TGCCGACTCTACCAGGCTA -> GCCGACTCTACCAGGCTAT
TGCCGAGGCCTCTCGCAAC -> GCCGAGGCCTCTCGCAACC
TGCCGCACCAAGCAGTAGA -> GCCGCACCAAGCAGTAGAA
TGCCGCCCAATTGAGAGTA -> GCCGCCCAATTGAGAGTAT
TGCCTCCCTAATTTCGCGT -> GCCTCCCTAATTTCGCGTT
TGCCTTAGCAGGTTATTAA -> GCCTTAGCAGGTTATTAAT
TGCGAAGGACTAGGTGAGT -> GCGAAGGACTAGGTGAGTG
TGCGCGACCGCGGAACTAG -> GCGCGACCGCGGAACTAGG
TGCGTCCAAGTGGCAGGCG -> GCGTCCAAGTGGCAGGCGG
TGCTAGTCGGCACTCGAGG -> GCTAGTCGGCACTCGAGGG
TGCTCGCGAGCATGGGTTA -> GCTCGCGAGCATGGGTTAG
TGCTGAACGCATCCGGATC -> GCTGAACGCATCCGGATCG
TGCTGCCAGACTAACATAG -> GCTGCCAGACTAACATAGA
TGCTGGGGCGCTCGTCACA -> GCTGGGGCGCTCGTCACAG
TGCTTTCGTAACTTAAGTC -> GCTTTCGTAACTTAAGTCC
TGGAATGGTACGAGTGAAG -> GGAATGGTACGAGTGAAGT
TGGACCCCCACACTGAAGA -> GGACCCCCACACTGAAGAC
TGGAGCAATGTTCCAACAC -> GGAGCAATGTTCCAACACT
TGGAGCATAAGGCACTGGT -> GGAGCATAAGGCACTGGTC
TGGAGCGATATTAATCTAA -> GGAGCGATATTAATCTAAG
TGGATAAGGTGAGATTGAA -> GGATAAGGTGAGATTGAAG
TGGATGCCGCACCAAGCAG -> GGATGCCGCACCAAGCAGT
TGGCAGAAAGCAGCTCACA -> GGCAGAAAGCAGCTCACAG
TGGCAGGCGGCCAAGACGC -> GGCAGGCGGCCAAGACGCA
TGGCATACCCCTAACCTGA -> GGCATACCCCTAACCTGAC
TGGCCGCATAGTAGTCGGA -> GGCCGCATAGTAGTCGGAT
TGGCCTTCTCCATGCCACA -> GGCCTTCTCCATGCCACAC
TGGCGATTGGATGCCGCAC -> GGCGATTGGATGCCGCACC
TGGCGCATAATACCATAGC -> GGCGCATAATACCATAGCA
TGGGAACAACTTCCACACG -> GGGAACAACTTCCACACGA
TGGGCTTACTACGTATAAA -> GGGCTTACTACGTATAAAA
TGGGGCGCGCGCTCTTTGA -> GGGGCGCGCGCTCTTTGAA
TGGGGCGCTCGTCACAGCT -> GGGGCGCTCGTCACAGCTG
TGGGGTACCAGGCTATCGT -> GGGGTACCAGGCTATCGTC
TGGGGTAGTACATGTTTTT -> GGGGTAGTACATGTTTTTA
TGGGTCCGGCGGCGAGGAA -> GGGTCCGGCGGCGAGGAAG
TGGGTCTGTGTTCTGTTAT -> GGGTCTGTGTTCTGTTATT
TGGGTTAGATTAGGTTTTT -> GGGTTAGATTAGGTTTTTT
TGGGTTTCACAACGGTTGC -> GGGTTTCACAACGGTTGCC
TGGTAAGGTCAAAAGTTTC -> GGTAAGGTCAAAAGTTTCT
TGGTACGAGTGAAGTAAAA -> GGTACGAGTGAAGTAAAAT
TGGTCATCGGATAGGTAGC -> GGTCATCGGATAGGTAGCG
TGGTCCACGAGAACATCTA -> GGTCCACGAGAACATCTAC
TGGTCCCCTACGTGTTTCG -> GGTCCCCTACGTGTTTCGG
TGGTGATATACAGTAACCC -> GGTGATATACAGTAACCCC
TGGTGCCGCCCAATTGAGA -> GGTGCCGCCCAATTGAGAG
TGGTTTCGCGGGCTAACGC -> GGTTTCGCGGGCTAACGCA
TGTATAATGGGTCCGGCGG -> GTATAATGGGTCCGGCGGC
TGTATATTTTAGCCATGGG -> GTATATTTTAGCCATGGGT
TGTCAACTCTCTGACACTC -> GTCAACTCTCTGACACTCG
TGTCCTGTATAATGGGTCC -> GTCCTGTATAATGGGTCCG
TGTCGCCCAATATGATCCT -> GTCGCCCAATATGATCCTA
TGTCTAGTTGGTCATCGGA -> GTCTAGTTGGTCATCGGAT
TGTCTATGTTAGTTCCGGG -> GTCTATGTTAGTTCCGGGT
TGTGAAAACCCGCCCGTGA -> GTGAAAACCCGCCCGTGAC
TGTGAATACCGAAGTTGTT -> GTGAATACCGAAGTTGTTG
TGTGCGCGACCGCGGAACT -> GTGCGCGACCGCGGAACTA
TGTGGCAGAAAGCAGCTCA -> GTGGCAGAAAGCAGCTCAC
TGTGTTCGGCTCCCCTACA -> GTGTTCGGCTCCCCTACAT
TGTGTTCTGTTATTTGCCC -> GTGTTCTGTTATTTGCCCC
TGTTAACATTAGCGAGAAA -> GTTAACATTAGCGAGAAAT
TGTTAAGGGTATATTTGAG -> GTTAAGGGTATATTTGAGT
TGTTAGCCTGGGCTTACTA -> GTTAGCCTGGGCTTACTAC
TGTTAGTTCCGGGTGGATA -> GTTAGTTCCGGGTGGATAA
TGTTATTTGCCCCGTAGCG -> GTTATTTGCCCCGTAGCGG
TGTTCCAACACTCGGACTT -> GTTCCAACACTCGGACTTC
TGTTCCTCGACAATTCTGT -> GTTCCTCGACAATTCTGTT
TGTTCGGCATCCCCTTTGC -> GTTCGGCATCCCCTTTGCG
TGTTCGGCTCCCCTACATG -> GTTCGGCTCCCCTACATGG
TGTTCTGTTATTTGCCCCG -> GTTCTGTTATTTGCCCCGT
TGTTGGCCTTCTCCATGCC -> GTTGGCCTTCTCCATGCCA
TGTTGTTAAGGGTATATTT -> GTTGTTAAGGGTATATTTG
TGTTTCGGTGTGCGCGACC -> GTTTCGGTGTGCGCGACCG
TGTTTTTAGGACATTCTCC -> GTTTTTAGGACATTCTCCT
TGTTTTTCGATCAAAAGTT -> GTTTTTCGATCAAAAGTTA
TTAACATTAGCGAGAAATC -> TAACATTAGCGAGAAATCA
TTAACGAACTGAGTTTTCT -> TAACGAACTGAGTTTTCTA
TTAACGCCAATAATTTTGA -> TAACGCCAATAATTTTGAT
TTAAGGGTATATTTGAGTG -> TAAGGGTATATTTGAGTGA
TTAAGTCCAAAAGCCCTTT -> TAAGTCCAAAAGCCCTTTG
TTAATCGGTGGTCCACGAG -> TAATCGGTGGTCCACGAGA
TTAATCTAAGTTGTTTTTC -> TAATCTAAGTTGTTTTTCG
TTACAATCCGGGCGTACAT -> TACAATCCGGGCGTACATC
TTACCAGGCTATCGTCCAA -> TACCAGGCTATCGTCCAAT
TTACCCCACGTTTATGCCT -> TACCCCACGTTTATGCCTC
TTACGCTGGGGTACCAGGC -> TACGCTGGGGTACCAGGCT
TTACTACGTATAAAATGTC -> TACTACGTATAAAATGTCG
TTACTGATAGTCATCCCCG -> TACTGATAGTCATCCCCGA
TTAGACATCAGGCCACGAG -> TAGACATCAGGCCACGAGC
TTAGACCGCGTCAATTGAA -> TAGACCGCGTCAATTGAAA
TTAGATTAGGTTTTTTGAA -> TAGATTAGGTTTTTTGAAA
TTAGCAGGTTATTAATCGG -> TAGCAGGTTATTAATCGGT
TTAGCCATGGGTTTCACAA -> TAGCCATGGGTTTCACAAC
TTAGCCTGGGCTTACTACG -> TAGCCTGGGCTTACTACGT
TTAGCGAGAAATCAAAACA -> TAGCGAGAAATCAAAACAG
TTAGGACATTCTCCTGGAC -> TAGGACATTCTCCTGGACC
TTAGGACGAACTAGGGGCC -> TAGGACGAACTAGGGGCCT
TTAGGTTTTTTGAAATCTG -> TAGGTTTTTTGAAATCTGG
TTAGTACTTGCGTCCAAGT -> TAGTACTTGCGTCCAAGTG
TTAGTCACATTCATACTTC -> TAGTCACATTCATACTTCT
TTAGTTCCGGGTGGATAAG -> TAGTTCCGGGTGGATAAGG
TTATACGGACCAGTGGCGC -> TATACGGACCAGTGGCGCA
TTATCCAAATTCATACGAA -> TATCCAAATTCATACGAAG
TTATCTGGGGCGCGCGCTC -> TATCTGGGGCGCGCGCTCT
TTATGCCTCCCTAATTTCG -> TATGCCTCCCTAATTTCGC
TTATGTCAACTCTCTGACA -> TATGTCAACTCTCTGACAC
TTATTAATCGGTGGTCCAC -> TATTAATCGGTGGTCCACG
TTATTTGCCCCGTAGCGGT -> TATTTGCCCCGTAGCGGTA
TTCAAACCAGCGCGTCCCG -> TCAAACCAGCGCGTCCCGC
TTCACAACGGTTGCCTTAG -> TCACAACGGTTGCCTTAGC
TTCAGCCCTTATCCAAATT -> TCAGCCCTTATCCAAATTC
TTCAGTACAGCTACTTTGG -> TCAGTACAGCTACTTTGGA
TTCATACGAAGCACAGGAG -> TCATACGAAGCACAGGAGG
TTCATACTTCTGAAAACAG -> TCATACTTCTGAAAACAGA
TTCATCCGTCCAAATGACC -> TCATCCGTCCAAATGACCC
TTCCAACACTCGGACTTCT -> TCCAACACTCGGACTTCTC
TTCCACACGAAGTATAGCC -> TCCACACGAAGTATAGCCC
TTCCCCTAACCTGACAGAG -> TCCCCTAACCTGACAGAGT,TCCCCTAACCTGACAGAGT
TTCCCGTGGTTTCGCGGGC -> TCCCGTGGTTTCGCGGGCT
TTCCCTTCCGGAGCAGTTT -> TCCCTTCCGGAGCAGTTTA
TTCCGGAGCAGTTTAGACA -> TCCGGAGCAGTTTAGACAT
TTCCGGGTGGATAAGGTGA -> TCCGGGTGGATAAGGTGAG
TTCCTATCGTTCCCCTAAC -> TCCTATCGTTCCCCTAACC
TTCCTCGACAATTCTGTTA -> TCCTCGACAATTCTGTTAG
TTCCTCGATCGGGGACCAT -> TCCTCGATCGGGGACCATC
TTCGATCAAAAGTTACTGA -> TCGATCAAAAGTTACTGAT
TTCGCCACGTCCTGTATAT -> TCGCCACGTCCTGTATATT
TTCGCCCAAGCGTTGATCG -> TCGCCCAAGCGTTGATCGA
TTCGCGGGCTAACGCAGTA -> TCGCGGGCTAACGCAGTAG
TTCGCGTTGTCTATGTTAG -> TCGCGTTGTCTATGTTAGT
TTCGGCATCCCCTTTGCGA -> TCGGCATCCCCTTTGCGAA
TTCGGCTCCCCTACATGGG -> TCGGCTCCCCTACATGGGT
TTCGGTGTGCGCGACCGCG -> TCGGTGTGCGCGACCGCGG
TTCGTAACTTAAGTCCAAA -> TCGTAACTTAAGTCCAAAA
TTCTACGCTAAGAGGGTCG -> TCTACGCTAAGAGGGTCGT
TTCTATTCTGAAGCTAACA -> TCTATTCTGAAGCTAACAG
TTCTCCATGCCACACACTG -> TCTCCATGCCACACACTGT
TTCTCCCCCACCCAACTTG -> TCTCCCCCACCCAACTTGG
TTCTCCTGGACCCCCACAC -> TCTCCTGGACCCCCACACT
TTCTGAAAACAGAGCACGC -> TCTGAAAACAGAGCACGCC
TTCTGAAGCTAACAGGACA -> TCTGAAGCTAACAGGACAT
TTCTGTTAGCCTGGGCTTA -> TCTGTTAGCCTGGGCTTAC
TTCTGTTATTTGCCCCGTA -> TCTGTTATTTGCCCCGTAG
TTCTTTATCTGGGGCGCGC -> TCTTTATCTGGGGCGCGCG
TTCTTTCATCCGTCCAAAT -> TCTTTCATCCGTCCAAATG
TTGAAAAGTTTCTTTATCT -> TGAAAAGTTTCTTTATCTG
TTGAAATCTGGAATGGTAC -> TGAAATCTGGAATGGTACG
TTGAAGAGGAGGGACTGAA -> TGAAGAGGAGGGACTGAAG
TTGAAGTTACAATCCGGGC -> TGAAGTTACAATCCGGGCG
TTGAGAGTATCCAATCAGT -> TGAGAGTATCCAATCAGTC
TTGAGTGAGGAAAGCTTTA -> TGAGTGAGGAAAGCTTTAT
TTGATATCGAAGACAAGCA -> TGATATCGAAGACAAGCAG
TTGATCGACCTGTGTTCGG -> TGATCGACCTGTGTTCGGC
TTGATTCGCCACGTCCTGT -> TGATTCGCCACGTCCTGTA
TTGCCCCGTAGCGGTACAC -> TGCCCCGTAGCGGTACACC
TTGCCTTAGCAGGTTATTA -> TGCCTTAGCAGGTTATTAA
TTGCGAAGGACTAGGTGAG -> TGCGAAGGACTAGGTGAGT
TTGCGTCCAAGTGGCAGGC -> TGCGTCCAAGTGGCAGGCG
TTGCTGGGGCGCTCGTCAC -> TGCTGGGGCGCTCGTCACA
TTGCTTTCGTAACTTAAGT -> TGCTTTCGTAACTTAAGTC
TTGGAGCAATGTTCCAACA -> TGGAGCAATGTTCCAACAC
TTGGATGCCGCACCAAGCA -> TGGATGCCGCACCAAGCAG
TTGGCATACCCCTAACCTG -> TGGCATACCCCTAACCTGA
TTGGCCTTCTCCATGCCAC -> TGGCCTTCTCCATGCCACA
TTGGGGTAGTACATGTTTT -> TGGGGTAGTACATGTTTTT
TTGGTCATCGGATAGGTAG -> TGGTCATCGGATAGGTAGC
TTGGTGCCGCCCAATTGAG -> TGGTGCCGCCCAATTGAGA
TTGTCTATGTTAGTTCCGG -> TGTCTATGTTAGTTCCGGG
TTGTTAAGGGTATATTTGA -> TGTTAAGGGTATATTTGAG
TTGTTGTTAAGGGTATATT -> TGTTGTTAAGGGTATATTT
TTGTTTTTCGATCAAAAGT -> TGTTTTTCGATCAAAAGTT
TTTAACGCCAATAATTTTG -> TTAACGCCAATAATTTTGA
TTTAGACATCAGGCCACGA -> TTAGACATCAGGCCACGAG
TTTAGCCATGGGTTTCACA -> TTAGCCATGGGTTTCACAA
TTTAGGACATTCTCCTGGA -> TTAGGACATTCTCCTGGAC
TTTAGTACTTGCGTCCAAG -> TTAGTACTTGCGTCCAAGT
TTTATACGGACCAGTGGCG -> TTATACGGACCAGTGGCGC
TTTATCTGGGGCGCGCGCT -> TTATCTGGGGCGCGCGCTC
TTTATGCCTCCCTAATTTC -> TTATGCCTCCCTAATTTCG
TTTCAAACCAGCGCGTCCC -> TTCAAACCAGCGCGTCCCG
TTTCACAACGGTTGCCTTA -> TTCACAACGGTTGCCTTAG
TTTCATCCGTCCAAATGAC -> TTCATCCGTCCAAATGACC
TTTCGATCAAAAGTTACTG -> TTCGATCAAAAGTTACTGA
TTTCGCGGGCTAACGCAGT -> TTCGCGGGCTAACGCAGTA
TTTCGCGTTGTCTATGTTA -> TTCGCGTTGTCTATGTTAG
TTTCGGTGTGCGCGACCGC -> TTCGGTGTGCGCGACCGCG
TTTCGTAACTTAAGTCCAA -> TTCGTAACTTAAGTCCAAA
TTTCTACGCTAAGAGGGTC -> TTCTACGCTAAGAGGGTCG
TTTCTATTCTGAAGCTAAC -> TTCTATTCTGAAGCTAACA
TTTCTTTATCTGGGGCGCG -> TTCTTTATCTGGGGCGCGC
TTTGAAATCTGGAATGGTA -> TTGAAATCTGGAATGGTAC
TTTGAAGTTACAATCCGGG -> TTGAAGTTACAATCCGGGC
TTTGAGTGAGGAAAGCTTT -> TTGAGTGAGGAAAGCTTTA
TTTGATATCGAAGACAAGC -> TTGATATCGAAGACAAGCA
TTTGATTCGCCACGTCCTG -> TTGATTCGCCACGTCCTGT
TTTGCCCCGTAGCGGTACA -> TTGCCCCGTAGCGGTACAC
TTTGCGAAGGACTAGGTGA -> TTGCGAAGGACTAGGTGAG
TTTGCTTTCGTAACTTAAG -> TTGCTTTCGTAACTTAAGT
TTTGGAGCAATGTTCCAAC -> TTGGAGCAATGTTCCAACA
TTTGGCATACCCCTAACCT -> TTGGCATACCCCTAACCTG
TTTTAGCCATGGGTTTCAC -> TTTAGCCATGGGTTTCACA
TTTTAGGACATTCTCCTGG -> TTTAGGACATTCTCCTGGA
TTTTCGATCAAAAGTTACT -> TTTCGATCAAAAGTTACTG
TTTTCTACGCTAAGAGGGT -> TTTCTACGCTAAGAGGGTC
TTTTGAAATCTGGAATGGT -> TTTGAAATCTGGAATGGTA
TTTTGATATCGAAGACAAG -> TTTGATATCGAAGACAAGC
TTTTTAGGACATTCTCCTG -> TTTTAGGACATTCTCCTGG
TTTTTCGATCAAAAGTTAC -> TTTTCGATCAAAAGTTACT
TTTTTGAAATCTGGAATGG -> TTTTGAAATCTGGAATGGT
TTTTTTGAAATCTGGAATG -> TTTTTGAAATCTGGAATGG